<start> albert jennings fountain served in the union army . <end>	<start> the birth date of the bbc comics character is charles elkin mathews . <end>
<start> buzz aldrin was born in glen ridge , nj . he was a member of the apollo 11 crew , organized by nasa . he is now retired . william anders was a backup pilot for apollo 11 . <end>	<start> buzz aldrin was born in glen ridge , new jersey and was a crew member of apollo 11 operated by nasa . he is now retired . <end>
<start> christian burns plays the guitar . <end>	<start> the character baymax was created by the house of representatives . <end>
<start> the language of finland is the finnish language . <end>	<start> the language spoken in iraq . <end>
<start> anders osborne musical career began in 1989 . his career began in the blue's genre . he has been associated with the band , galactic as well as tab benoit . osborne also has ties to fellow musician billy iuso . <end>	<start> alan shepard was born in new hampshire and served as a test pilot . the institute was awarded the distinguished service medal from the us navy , which is higher than the u . s . and the state of commerce gold medal . the main ingredients are carrol service 16 several carrol service 16 fighting meat . the main ingredients are carrol service and the main ingredients of the american and the american and the american navy , which is the library of the library of the library of the library of the library of the library of the library of the library of the library of the library of the library of the library of the library of alan shepard also known as the library of the library of the library of the library of the library of the library of the library of the library of the library of the library of the library of the library of the library of the library of commerce gold force is carrol . alan shepard also the library of commerce gold places on the library of the library of commerce gold force is the library of the library of the library of the library of commerce gold force and the library of commerce gold office to the library of commerce gold office in the 1st alan shepard away in the 1st alan shepard alan shepard 
<start> aaron boogaard is from canada whose national anthem is o canada and its leader being elizabeth ii . one ethnic group in canada are asian canadians . <end>	<start> the leader of the country is called the prime minister of romania and the ethnic group is the british people . the country is the location of the book alcatraz versus the evil librarians which is part of the country . <end>
<start> 20 fenchurch street has an area of 62145 . 3 square metres and 34 floors . <end>	<start> 20 fenchurch street has a floor area of 62145 . 3 square metres , and has a floor area of 62145 . 3 square metres . <end>
<start> sumitra mahajan is a leader in india . <end>	<start> the leader of india is sumitra mahajan . <end>
<start> gus poyet played for chelsea f . c . and was the manager for aek athens fc but he is now in the real zaragoza club . <end>	<start> gus poyet has been manager of aek athens fc and plays for chelsea f . c . gus poyet is in the real zaragoza club . <end>
<start> yuzhnoye design office created the antares rocket whose initial flight took place july 13 , 2014 at the mid atlantic regional spaceport launch pad 0 . the rocket is 3 . 9 m in diameter and took its last trip on oct . 28 , 2014 . <end>	<start> the inauguration date of the bbc are edwin e . october 1983 and was on the 3rd october 1983 and was founded by huseyin butuner and hilmi guner . he is now retired . <end>
<start> gabriela michetti is the leader of argentina . <end>	<start> the leader of albuquerque is called stephen dilts . <end>
<start> the a . s . gubbio 1910 has 5300 members . <end>	<start> a . s . gubbio has 5300 members . <end>
<start> adisham hall is located in haputale . <end>	<start> adisham hall is located in haputale . <end>
<start> the leader party in madrid spain in which the adolfo suarez madrid barajas airport is located , is called ahora madrid . <end>	<start> the adolfo suarez madrid barajas airport is located in alcobendas which is part of the community of madrid in spain . <end>
<start> elliot see , a us national , was born in dallas and graduated from the university of texas at austin . <end>	<start> elliot see was born in dallas and attended the university of texas at austin . <end>
<start> meringue , ice cream , sponge cake or christmas pudding are the main ingredients of baked alaska which is popular in paris , new york and hong kong and originated in the united states . <end>	<start> the main ingredients of baked alaska are meringue , ice cream and sponge cake or christmas pudding . the dish comes from the united states and is also found in paris . the main ingredients are meringue , ice cream and sponge cake or christmas pudding . <end>
<start> ben urich's full name is actually benjamin urich . <end>	<start> ben urich's full name is benjamin urich . <end>
<start> jens hartel has represented the club fc sachsen leipzig . <end>	<start> jens hartel played for fc sachsen leipzig . <end>
<start> al asad airbase is in iraq , where they speak arabic . <end>	<start> al asad airbase is located in iraq where the language is arabic . <end>
<start> arrabbiata is an italian sauce that contains chili pepper . <end>	<start> tomatoes , italy includes tomatoes , garlic as one of its ingredients . <end>
<start> allan shivers started his career from january 21 , 1947 . <end>	<start> the start date for alan shepard started on 10 01 01 6 . <end>
<start> alderney airport , whose runway is 877 m , serves the city of alderney . its surface is poaceae . <end>	<start> the 1st runway at alderney airport is made from poaceae and is 497 . 0 in length . <end>
<start> walter baade , who had the doctoral student halton arp , was the discoverer of 1036 ganymed . he studied at the university of gottingen and died in west germany . <end>	<start> the founder of the comics character is john van den brom who was born in dallas and served as a fighter pilot and was a crew member of the nasa operated apollo 11 . <end>
<start> alfred garth jones was in england in 1872 . <end>	<start> born in buxton , john cowper powys was born in aberdeen . <end>
<start> the leader of birmingham is the conservative party uk , this city is the home town of john madin who was the architect that designed 103 colmore row . <end>	<start> the architect john madin was the architect of 103 colmore row which was designed by the conservative party . <end>
<start> 103 hera has an apoapsis of 437170000 km , an orbital period of 1622 . 213 days and an epoch date of 27 august 2011 . <end>	<start> the 2nd runway at amsterdam airport new zealand is 1 , 121 . the square metres above sea level and has a total area of 1 , 873 . <end>
<start> mark rutte is a leader of the netherlands in which the euro is currency and agnes kant is a national . <end>	<start> the currency of the country is the euro and the currency is the euro and the currency is the euro is the currency of the currency of the country . <end>
<start> aleksandra kovac plays pop music for the k2 band . he knows musician , bebi dol . <end>	<start> the architect of alan shepard is robert a glastonbury romance and the sequel to the grantville gazettes including the grantville gazette iii . the black manor is also known as the grantville gazettes and the grantville gazettes service preceded the grantville gazettes . <end>
<start> st louis , part of greater st louis , is led by francis g slay and is the birthplace of alex tyus . <end>	<start> st louis , whose mayor is francis g slay , is affiliated with the university of texas system and is the location of elliot see who died in st . louis . <end>
<start> baku is the capital of azerbaijan where the legislature is the national assembly and the leader is artur rasizade . the country is the location of the baku turkish martyrs memorial which is dedicated to the soldiers of the ottoman army who lost their lives in the battle of baku . <end>	<start> the capital of azerbaijan is baku and the legislature is the national assembly . the country is the location of the baku turkish martyrs memorial which is dedicated to the soldiers of the ottoman army who died in the battle of baku . the capital city of azerbaijan is baku and the legislature is the national assembly . <end>
<start> located in icolo e bengo , angola international airport serves luanda . the airport is 159 metres above the sea level , has a runway length of 3800 and the runway name , 05l 23r . <end>	<start> angola international airport is located 159 metres above sea level and has a runway length of 4000 . 0 . it is located at icolo e bengo , angola international airport and has a runway length of 4000 . <end>
<start> albany is part of benton county in oregon within the united states where asian americans are an ethnic group . <end>	<start> the asian americans are an ethnic group in the united states where the leader is called the asian south africans . <end>
<start> walt disney studio motion picture distributed the film big hero 6 , in which ryan potter starred and baymax is a character . <end>	<start> the distributor of big hero 6 , starring ryan potter potter potter potter potter potter potter potter potter potter potter is walt disney studios motion pictures . <end>
<start> there are 60 floors at 300 north lasalle , which is located in chicago . <end>	<start> 300 north lasalle , with 60 floors , is located in chicago . <end>
<start> colin powell was a commander in the gulf war . <end>	<start> the commander of the state of texas was david scott . <end>
<start> the american locomotive company was founded in schenectady , new york and built the alco rs 3 which is 17068 . 8 mms in length . <end>	<start> the founder of the comics character is john cowper powys , who publish the bodley series and the location of the ac hotel bella sky in new york . <end>
<start> 101 helena has an apoapsis of 441092000 . 0 kilometres . <end>	<start> the total area of akron cakes is 100 . <end>
<start> the leader for albuquerque , new mexico in the united states is the united states house of representatives . <end>	<start> the united states house of representatives is the leader of albuquerque , new mexico which is the location of the united states house of representatives . <end>
<start> al anderson plays the guitar for the rock band nrbq . rock music originated from country music and is an element of the fusion genre bhangra . <end>	<start> the american alan shepard has the alternative name of the dish dane whitman , and was created by robert a m stern and is also known as the following rice museum of art and is located in new york sauce . the institute of technology has the alternative location of the black journal , the black pudding and has been awarded the inkpot sauce . <end>
<start> allen forrest was born in fort campbell . in1981 . he is an acoustic solo singer . <end>	<start> buzz aldrin was born in glen ridge , new hampshire and was part of the apollo 11 crew . <end>
<start> alaa abdul zahra , played for the iraq national under 23 football team , plays for al kharaitiyat sc , located in al khor , and managed by , amar osim . <end>	<start> the manager of acf fiorentina , is peter stoger who plays for both the austria national football team and favoritner the austria national football team and the austria wien club . <end>
<start> audi was founded by august horch . <end>	<start> the founder of bananaman is john cowper powys . <end>
<start> bangalore in the state of karnataka , india is the location of the acharya institute of technology established in the year 2000 . the motto of the institute is nurturing excellence , the director is dr g p prabhukumar and the president is b m reddy . <end>	<start> the acharya institute of technology is located in bangalore , karnataka , india . its director is dr . g . p . prabhukumar and its president is b . m . reddy and the institute is affiliated with the visvesvaraya technological university in belgaum . <end>
<start> the novel aenir , which was written in english , was followed by above the veil which is from australia . <end>	<start> aenir is a novel written in english and was followed by above the veil . <end>
<start> baked alaska is served in the region of hong kong and known to be from the usa . the main ingredients are meringue , ice cream and sponge cake or christmas pudding . <end>	<start> baked alaska is from the region of hong kong and the main ingredients are meringue , ice cream and sponge cake or christmas pudding . the dish comes from the region of the u . s . the main ingredients are meringue , ice cream and sponge cake or christmas pudding . <end>
<start> julia morgan , the architect , was born in san francisco and some of her significant projects include asilomar conference grounds , the riverside art museum , hearst castle and asilomar state beach . <end>	<start> julia morgan was born in san francisco and designed several significant buildings including the asilomar state beach and the asilomar state beach . the riverside art musuem , and asilomar state beach . <end>
<start> george winkler was the architect of 320 south boston building . <end>	<start> the architect of 320 south boston building was george richard george building . <end>
<start> new jersey is a region served by the port authority of new york and new jersey . <end>	<start> the port authority of new york and new jersey serves the city of antwerp . <end>
<start> the manufacturer of the aston martin v8 is the aston martin . <end>	<start> the founder of the comics character . <end>
<start> william anders is an american who was born in british hong kong . he became a fighter pilot and later a member of the crew on apollo 8 . he retired on 1 september 1969 . <end>	<start> william anders was born in british hong kong on october 17th 1933 . he served as a fighter pilot and retired on september 1st , 1969 . <end>
<start> abradab who was born on november 12th 1978 is an artist for the band kaliber 44 and he is with rapper associated with magri . <end>	<start> alan shepard was born on march 15 , 1932 in wheeler , texas . he was a test pilot and was selected by nasa in 1963 . <end>
<start> the runway length of al taqaddum air base is 3684 . 0 . <end>	<start> the runway length at al taqaddum air base is 3684 . <end>
<start> the aidaluna has a top speed is 40 . 744 and is 252000 . 0 mms in length . <end>	<start> the manager of az alkmaar is robert a . m . and has a floor count of 50 . <end>
<start> gabor kubatov is the chairman of ferencvarosi tc . <end>	<start> the chairman of the chairman of amsterdam comics academy is dave laughlin . <end>
<start> buzz aldrin was born in glen ridge , new jersey , was part of apollo 11 and in 1963 graduated with a sc . d . from mit and is now retired . <end>	<start> buzz aldrin was born in glen ridge , new jersey and graduated from massachusetts institute of technology in 1963 with a doctorate in science . he was a crew member of apollo 11 and is now retired . <end>
<start> inaugurated on the 27th of july , 1932 , the ataturk monument izmir is located in turkey . the largest city is istanbul , and the capital is ankara . the country's president is ahmet davutoglu , and the currency is the turkish lira . <end>	<start> turkey's capital is ankara and the largest city is istanbul . the leader of turkey is ahmet davutoglu . the ataturk monument izmir is located in turkey . the capital of turkey is ankara and the currency is the turkish lira . <end>
<start> the acharya institute of technology is located in bangalore , india . it is affiliated with the visvesvaraya technological university and its directore is dr . g . p . prabhukumar . <end>	<start> the acharya institute of technology is affiliated with the visvesvaraya technological university in the city of bangalore in the state of karnataka which is affiliated with the visvesvaraya technological university . <end>
<start> anandiben patel was the leader of gujarat , india , where amdavad ni gufa is located . the leader of india's name is sumitra mahajan . <end>	<start> anandiben patel is the leader of india where amdavad ni gufa is located in ahmedabad . the leader of gujarat is sumitra mahajan . <end>
<start> the aston martin v8 , manufactured by aston martin , is related to the aston martin dbs and was succeeded by the aston martin vantage . its engine volume is 5 . 3 litres . and it is assembled at newport pagnell . <end>	<start> the director of the acharya institute of technology is robert a . m . and it was founded in 1904 and is dr . g . p . and the abbreviation of the institute of mobility and public and the institute is related to the school of management . <end>
<start> to the southeast of adams county , pennsylvania lies carroll county , maryland . <end>	<start> adams county pennsylvania is located to the southeast of franklin county , pennsylvania . <end>
