<start> the antwerp international airport is operated by the flemish government . <end>	<start> antwerp international airport is operated by the flemish government which has jurisdiction of the flemish government . <end>
<start> the 1st runway at alderney airport has an asphalt surface and a length of 877 . <end>	<start> the 1st runway at alderney airport is made from asphalt and has a length of 877 . 0 . <end>
<start> tennessee titans are based in nashville , tennessee . <end>	<start> the largest city in punjab , oregon . <end>
<start> the school of business and social sciences at the aarhus university in aarhus , denmark was established in 1928 . it has 16 , 000 students and 737 academic staff . the leader of denmark is lars lokke rasmussen . <end>	<start> the school of business and social sciences at the aarhus university in denmark was established in 1928 . it has 737 academic staff and 16 , 000 students . its dean is thomas pallesen . <end>
<start> luciano spalletti played for udinese calcio . <end>	<start> luciano spalletti plays for udinese calcio . <end>
<start> the aids journal comes under the academic discipline hiv aids and has the issn number 0269 9370 . <end>	<start> the aids journal is published in hiv aids and belongs to the academic discipline hiv aids . the journal has the issn number 0269 9370 . <end>
<start> 103 colmore row was designed by john madin who was born in birmingham . <end>	<start> 103 colmore row was designed by john madin born in birmingham and is located in birmingham . <end>
<start> 300 north lasalle is in chicago , cook county , illinois , usa . rahm emanuel is the leader of the aforementioned city . <end>	<start> 300 north lasalle is located in chicago , cook county , illinois , united states . the leader of chicago is rahm emanuel . <end>
<start> 11264 claudiomaccone has a temperature of 173 . 0 kelvins . <end>	<start> the runway length of az alaska is 8 square kilometres . <end>
<start> the school of business and social sciences at the aarhus university was established in 1928 . it is affiliated with the european university association in brussels . <end>	<start> the school of business and social sciences at the aarhus university was established in 1928 and is affiliated with the european university association headquartered in brussels . <end>
<start> bandeja paisa originates from the paisa region . <end>	<start> bandeja paisa is a traditional dish from the paisa region . <end>
<start> a loyal character dancer which is in print , was penned by qiu xiaolong . <end>	<start> a loyal character dancer was written by qiu xiaolong and published in print . <end>
<start> the alfa romeo 164 has a 4 speed automatic zf 4hp18qe transmission . <end>	<start> the architect of the akita museum of art is 4 4 fillings . <end>
<start> 10 hygiea , formerly known as a900 ga , has an orbit time of 5 . 57 days and a periapsis of 416136000000 . 0 . it has an epoch date of june 27th 2015 . <end>	<start> the inauguration date of the turkish institute of technology is edwin e . 2 fox and has a total area of 1 fc magdeburg . the latter national anthem is charles january 20 . <end>
<start> 250 delaware avenue is located in the united states , where english is spoken and the leader has the title president . joe biden is one of the leaders . <end>	<start> the english language is spoken in the united states where the leader is called the president . the country is the location of 250 delaware avenue . <end>
<start> amsterdam airport schiphol is 3 . 3528 below sea level and its first runway is made of asphalt . . <end>	<start> amsterdam airport schiphol is at an elevation of 3 . 3528 from sea level and the 1st runway is made from asphalt . <end>
<start> americans are the people occupying the us and one of the ethnic groups are the african americans . english is the language spoken in the us . angola is in steuben county , indiana , which is part of the united states . <end>	<start> the ethnic group of the united states are the ethnic group of the country where the english language is spoken and the country is the origin of the dish batchoy which originated in the country . <end>
<start> aaron hunt played for sv werder bremen and sv werder bremen ii . the latter is managed by alexander nouri and is in the league 3 liga . <end>	<start> the manager of afc ajax is peter stoger who plays for both the real vorwarts steyr and manages afc ajax . he is also in the real zaragoza club . <end>
<start> abner w . sibal was born in ridgewood , queens and a member of the republic party of the u . s . he was also a member of the connecticut senate from the 26th district . <end>	<start> the architect of the 14th new jersey volunteer infantry monument is robert a . m . a . in the united states and was born on the 17th of october 17th , san francisco . the memorial has been provided by the all national park service and the issn number of the 1st of the 1st of the 1st of the 1st of the 1st of the 1st of the 1st of the 1st of the 1st of the 1st of the 1st of the 1st of the 1st of the 1st of the 1st of the 1st of the 1st of william anders . <end>
<start> bionico is a dessert dish from the jalisco region of mexico and contains the ingredients chopped fruits , sour cream , condensed milk , granola , shredded coconut and raisins . <end>	<start> bionico is a dessert from the region of mexico and contains chopped fruits , sour cream , condensed milk , granola , shredded coconut and raisins . it is served as a dessert and raisins . <end>
<start> the aidastella was completed on march 11th 2013 . <end>	<start> the inauguration date of alan bean was on the 15th of july , 1932 . <end>
<start> norbert lammert is a leader in germany . <end>	<start> the leader of the comics minister of mexico is don cameron . <end>
<start> the musical genre of aleksandra kovac is rhythm and blues . <end>	<start> the novel into battle is preceded by the grantville gazette . <end>
<start> al kharaitiyat sc play in the qatar stars league . <end>	<start> the bbc is made out of elkin linz . <end>
<start> agnes kant is a national of the netherlands , the leader of which , is mark rutte . agnes kant worked at the netherlands house of representatives , the leader of which , is khadija arib . <end>	<start> the leader of the country is called the prime minister of the prime minister of the ram naik and the currency is the indian air force . the country is the location of the comic character , the memorial which has the alternative name of the boeing c 17 globemaster iii . <end>
<start> the total area of atlantic city , new jersey is 44 . 125 square kilometres and the population density is 1421 . 2 inhabitants per square kilometre . 609 is the area code of atlantic city , n . j . and mayor is the title of the leader . <end>	<start> the population density of atlantic city , new jersey is 1421 . the local area of atlantic city international airport is 3048 . 2 inhabitants per square kilometre . the local area of the local area of atlantic city is 3048 . 2 inhabitants per square kilometre . <end>
<start> christian heinrich friedrich peters was the discoverer of 109 felicitas . <end>	<start> buzz aldrin's founder was edwin eugene aldrin . <end>
<start> the alvis speed 25 has a straight six engine and an impressive transmission . <end>	<start> the main ingredients of the dish of the dish of the dish baymax are compressed rice and vegetables and minced meat fillings . the dish is served as a variation of the black journal , which is located in the municipality of the state of new york and has different names including the all office service with vegetables of william meat fillings . <end>
<start> asam pedas is a food found in malaysia , where the capital is kuala lumpur , and arifin zakaria is the leader . <end>	<start> asam pedas is a food found in malaysia , where the capital is kuala lumpur and the leader is najib razak . <end>
<start> alfred n . phillips , born in connecticut , was a member of the democratic party in the united states , and was in the united states house of representatives . his successor was albert e . austin . <end>	<start> the american william anders was born in the united states on the 17th of october california . he was created by robert a heinlein , the american pilot of the united states navy and also known as the american national park service and the us national service jr . <end>
<start> the 3rd runway at ardmore airport new zealand is made of poaceae , and its length is 597 . 0 . <end>	<start> the runway length of ardmore airport new zealand is 597 . 0 . it is made of poaceae and has a runway length of 597 . 0 . <end>
<start> english is the language spoken in canada . <end>	<start> the language spoken in iraq is english . <end>
<start> a loyal character dancer is published by soho press , located in the united states . english is the main language of the u . s . , and is also spoken in great britain . the u . s . has an ethnic group called asian americans . <end>	<start> the english language is spoken in great britain and the united states . the us is home to many asian americans . the book is written in english , which is spoken in great britain . <end>
<start> the musical genre of alex day is synthpop . <end>	<start> the genre of new jersey is the genre of the genre of new genre . <end>
<start> the author of a glastonbury romance was john cowper powys , who was born in shirley , derbyshire and died in blaenau ffestiniog . <end>	<start> john cowper powys born in shirley , derbyshire , wrote wolf solent and a glastonbury romance . <end>
<start> asser levy public baths are located in new york city . <end>	<start> asser levy public baths are located in new york city , manhattan . <end>
<start> adam holloway , who was born in faversham , kent , england , is a member of the conservative party in the uk . he studied at magdalene college cambridge before joining the grenadier guards and later starting his political career on 5th may 2005 . <end>	<start> the architect of the 1st journal in the city of the united states was born on the 1st october , maryland , and it was created by john la beans , california and was born in the city . the main ingredients for the main ingredients of the institute of the 1st ingredients are huseyin butuner and hilmi guner . <end>
<start> marriott international is the tenant of ac hotel bella sky in copenhagen which has 23 floors was designed by the architects 3xn . <end>	<start> the ac hotel bella sky copenhagen is located in copenhagen and was designed by the architects 3xn firm . <end>
<start> abel caballero was born in ponteareas in galicia , spain and worked as a member of the congress of deputies . <end>	<start> born in san francisco and the founder of the essex county is the founder of the series of the series of the series of the series of bananaman who was also born in new hampshire and served as a test pilot . <end>
<start> airey neave born in knightsbridge , london , began his career on march 4th 1974 , fought in world war ii , and ended his career on 30th march 1979 . <end>	<start> the architect of alan shepard born on the 17th of october 1923 in new hampshire began in the 17th of october , 1933 . the building was started on the 17th of october 17th , 1933 . <end>
<start> atlantic city is part of atlantic county , new jersey , in the united states . <end>	<start> atlantic city international airport is located in egg harbor township , n . j . in the u . s . a . <end>
<start> luciano spalletti played for udinese calcio . <end>	<start> luciano spalletti plays for udinese calcio . <end>
<start> alessio romagnoli plays for a . s . roma . <end>	<start> christian panucci plays for the a . s . d . licata calcio . <end>
<start> motherwell fc's ground is fir park . <end>	<start> the ground of a . c . cesena . <end>
<start> barack obama is the leader of the united states where a wizard of mars was published . the book is in english , which is spoken in great britain . <end>	<start> barack obama is the president of the united states where english is the spoken language . the book a wizard of mars was published in english which is the language spoken in great britain . <end>
<start> 103 hera has an apoapsis of 437170000 km , an orbital period of 1622 . 213 days and an epoch date of 27 august 2011 . <end>	<start> the 2nd runway at amsterdam airport new zealand is 1 , 121 . the square metres above sea level and has a total area of 1 , 873 . <end>
<start> auburn is part of lee county in alabama in the u . s . the capital of the u . s . is washington , d . c . and native americans are one ethnic group in that country . <end>	<start> the capital of the united states are the ethnic group of the united states and the country is the location of the bacon explosion . the country is the location of the native state of the state of the state of the state of the state of the state of the state of the state of the state of the state of the state of the state of the state of the state of the state of the state of the state of the state of the state of the state of the state of the state of the state of the state of new york state of the state of the state of the state of the state of the state of the state of the state of the state of the state of the state of the state of the state of the state of the state of the state of the state of the state of america and the state of the state of the state of the state of the state of the state of the state of the state of the state of the state of the state of the state of the state of the state of the state of the state of the state of the state of the state of the state is washington of the state of the state of the state of the state of the state of the state of the state of the state of 
<start> the name of the runway at atlantic city international airport is 13 31 . <end>	<start> 13 31 is the runway name of atlantic city international airport . <end>
<start> alpharetta can be found in georgia in the united states , the country that is home to an ethnic group called asian americans . <end>	<start> the united states is home to the ethnic groups of the united states , where the capital city is washington d . c . and asian americans are one of the ethnic groups there . <end>
<start> alaa abdul zahra plays for al khor sports club located in al khor . <end>	<start> the manager of a . f . c . chievo verona is rolando maran . <end>
<start> found in mexico , the food , bionico with granola as an ingredient , is served at the dessert course . <end>	<start> bionico is a dessert found in mexico . it contains granola , bionico and raisins . <end>
<start> christian panucci plays at a . s . roma . he also manages a . s . livorno calcio . <end>	<start> a . s . livorno calcio are managed by christian panucci who plays for the italy national football team and manages a . s . livorno calcio . <end>
<start> malays and malaysian indians are both ethnic groups in malaysia , the capital city of which is kuala lumpur . asam pedas is a food found in malaysia . it comes from the sumatra and malay peninsula regions . <end>	<start> asam pedas is a food found in malaysia and malay peninsula in malaysia . the capital of the country is kuala lumpur and malaysian malay and malaysian malay are ethnic groups found in the country . <end>
<start> the leader of singapore is tony tan where english is spoken and beef kway teow is a popular dish . <end>	<start> tony tan is a leader in singapore where english is spoken and the dish beef kway teow is a popular dish . <end>
<start> anders osborne is associated with phil lesh and friends and he has worked with tab benoit . <end>	<start> the acharya institute of technology has the alternative name of alan shepard and was born in new hampshire and has the library of merit ribbon . <end>
<start> the acharya institute of technology's campus is located in soldevanahalli , acharya dr . sarvapalli radhakrishnan road , hessarghatta main road , bangalore 560090 , india . it is affiliated with the visvesvaraya technological university in belgaum . <end>	<start> the acharya institute of technology is affiliated with the visvesvaraya technological university in belgaum . the campus is located at soldevanahalli , acharya dr . sarvapalli radhakrishnan road , hessarghatta main road , bangalore 560090 . <end>
<start> an ingredient of bandeja paisa is lemon which belongs to the rutaceae family and falls under the order of rosids . bandeja paisa is a dish from the antioquia department region and the department is located in colombia . <end>	<start> lemon is an ingredient of bandeja paisa which comes from the antioquia region of colombia . the lemon is one of the ingredients in bandeja paisa which is part of the rutaceae family . <end>
<start> bionico is a food which contains raisins from guadalajara , mexico . <end>	<start> bionico is a food found in mexico and contains raisins . <end>
<start> 10 hygiea , formerly known as a900 ga , has an orbit time of 5 . 57 days and a periapsis of 416136000000 . 0 . it has an epoch date of june 27th 2015 . <end>	<start> the inauguration date of the turkish institute of technology is edwin e . 2 fox and has a total area of 1 fc magdeburg . the latter national anthem is charles january 20 . <end>
<start> bhajji originates from india where the currency is the indian rupee and the leaders are narendra modi and sumitra mahajan . <end>	<start> bhajji originates from india where the currency is the indian rupee and the currency is the indian rupee and narendra modi is the leader . <end>
<start> acharya institute of technology in bangalore , india was established in 2000 and its president is b . m . reddy . the school is affiliated with the visvesvaraya technological university and its full address is in soldevanahalli , acharya dr . sarvapalli radhakrishnan road , hessarghatta main road , bangalore 560090 . <end>	<start> the acharya institute of technology is located in soldevanahalli , acharya dr . sarvapalli radhakrishnan road , hessarghatta main road , bangalore 560090 , india . it was established in 2000 and it is affiliated with the visvesvaraya technological university in belgaum . <end>
<start> a severed wasp which has the isbn number 0 374 26131 8 , also has an oclc number of 8805735 . <end>	<start> a severed wasp has the isbn number 0 374 26131 8 and the isbn number of 0 374 26131 8 . <end>
<start> born 22nd september , 1856 , albert b . white's profession was politician . <end>	<start> buzz aldrin was born on the 17th of october 1923 and was selected by nasa in 1963 . <end>
<start> the malaysian chinese and malay are ethnic groups in malaysia where the capital is kuala lumpur . it is also where the food dish asam pedas , which come from the region of sumatra and the malay peninsula , is found . <end>	<start> asam pedas is a food found in malaysia and malay peninsula in malaysia . the capital of malaysia is kuala lumpur and malaysian chinese are ethnic groups from the country . <end>
<start> tim brooke taylor , star of bananaman was born in derbyshire . <end>	<start> tim brooke taylor starred in bananaman , broadcasted by stv . <end>
<start> albert jennings fountain was born in the united states where one of the ethnic groups are the african americans . he fought in the american civil war which included abraham lincoln among its commanders . <end>	<start> the united states national started to the african americans , was the architect of the bacon explosion which was published . the us includes many african americans . <end>
<start> alaa abdul zahra has played for al kharaitiyat sc and al zawra'a sc . al kharaitiyat sc . are managed by amar osim and play their home games at al khor . <end>	<start> the manager of acf fiorentina , is peter stoger who plays for both the following clubs lask linz . he also plays for both the following clubs lask linz , and manages the az alkmaair . <end>
<start> penarol , where abel hernandez played youth football , is managed by jorge orosman da silva . hernandez later played for uruguayan segunda division side central espanol and then moved to u . s . citta di palermo . <end>	<start> the champions of the azerbaijan premier development are robert a d who are the real zaragoza and also play . the latter manager is peter stoger who plays for the following ado den haag and the austria wien service were given to be part of the fk austria wien soccer club . <end>
<start> alfred moore scales , governor of north carolina was succeeded by james w reid . <end>	<start> the founder of the bbc is charles lee and he was born on the 11th october 1923 service and was founded in 1963 . <end>
<start> the american test pilot alan bean born in wheeler , texas was selected by nasa in 1963 . he is now retired . <end>	<start> alan bean is a us national who was born in wheeler , texas . he was selected by nasa in 1963 and served as a test pilot before joining nasa in 1963 . <end>
<start> alan b . miller hall was designed by robert a . m . stern it is located in virginia and it is owned by the college of william and mary . its current tenants are the mason school of business in the us . <end>	<start> the mason school of business are the current tenants of alan b miller hall , designed by robert a m stern and located in virginia , united states . the current tenant is the alan b miller hall , which is owned by the college of william and mary . <end>
<start> criona ni dhalaigh was lord mayor of dublin . <end>	<start> the mayor of dublin is criona ni dhalaigh who was born in dublin . <end>
<start> auburn , washington is in the u . s . and is part of king county while washington d . c . is the capital of the u . s . <end>	<start> washington d . c . capital is washington d . and the capital is washington dc . the capital city is washington dc . <end>
<start> massimo drago has been the manager of a c cesena but currently plays for us castrovillari calcio and ss chieti calcio . <end>	<start> massimo drago manages a . c . cesena and plays for u . s . d . and manages a . c . cesena . he also plays for us castrovillari calcio . <end>
<start> batchoy is a dish from the philippines , where arabic is spoken and where one of the ethnic groups is the igorot people . <end>	<start> the igorot people and igorot people are ethnic groups from the philippines . <end>
<start> addiction journal , or addiction , is about addiction and has the issn number of 1360 0443 . <end>	<start> the addiction journal abbreviated to addiction is about addiction and has the issn number 1360 0443 . <end>
<start> the city of anderson is part of lafayette township in the united states . it is located in madison county , indiana which has the capital city of indianapolis . <end>	<start> the capital of the united states is washington and the state is madison county , indiana . the country is the location of the school of lafayette township , madison county , indiana . <end>
<start> the akita museum of art is located in the akita prefecture of japan , in akita , akita . one ethnic group of japan is the vietnamese people . <end>	<start> the akita museum of art is located in akita , akita which is part of akita prefecture in japan . the emperor of japan is akihito and the ethnic group of japan . <end>
<start> orange county is in california , in the united states . <end>	<start> orange county , california is in the united states . <end>
<start> one of the languages of texas , the location of austin in hays county , is spanish . the county seat is san marcos but the largest city in texas is houston . <end>	<start> the largest city in texas is houston , texas , and the largest city is houston . the dish is the location of the regional airport , which is home to the regional airport , is the largest city in the state of texas , and the largest city is austin . <end>
<start> the acharya institute of technology offers tennis as its sport and it was given the technical campus status by the all india council for technical education located in mumbai . the sports governing body for tennis is the international tennis federation . <end>	<start> the acharya institute of technology is located in the city of bangalore and was given the technical campus status by the all india council for technical education based in mumbai . the institute offers tennis federation . <end>
<start> saranac lake is found in harrietstown , new york . adirondack regional airport serves saranac lake and lake placid city of new york . <end>	<start> adirondack regional airport is located in the united states , which is part of harrietstown , new york and is part of new york . the airport serves the city of lake placid and saranac lake in new york . <end>
<start> binignit comes from the philippines and has banana as the main ingredient . <end>	<start> the main ingredients of binignit are banana , but it also contains banana . <end>
<start> a . f . c . fylde are based at bryning lane and their full name is association football club fylde . they have 3180 members and competed in the 2014 season . <end>	<start> afc fylde has the full name association football club fylde , they have 3180 members and played in the 2014 15 season in the football league season . <end>
<start> anderson is the county seat of madison county , which is in indiana . <end>	<start> anderson is the county seat of madison county in indiana . <end>
<start> the ground for aek athens fc , who are in the superleague of greece is the olympic stadium athens . <end>	<start> aek athens fc have their ground at the olympic stadium athens , the olympic stadium athens . <end>
<start> marriott international is the tenant of ac hotel bella sky and is located in copenhagen . <end>	<start> the tenant of ac hotel bella sky copenhagen is marriott international . <end>
<start> akeem dent's former team is the atlanta falcons . <end>	<start> the bbc was born in aberdeen . <end>
<start> akita museum of art is located in japan , which has as one of its ethnic groups the brazilians . <end>	<start> the akita museum of art is located in akita , japan , where the ethnic group is the filipinos . <end>
<start> the country of akron , ohio , is united states , where english is the language spoken . <end>	<start> the english language is spoken in the united states where the language is english . <end>
<start> augustus pugin who was born in bloomsbury is the architect of adare manor . another of his significant buildings is the palace of westminster . <end>	<start> the architect of adare manor is augustus pugin , who was born in bloomsbury , and designed the palace of westminster . <end>
<start> hip hop music , with origins in disco and funk , is the genre of musician , ace wilder . <end>	<start> the american journal of mathematics has the abbreviation of the arts and crafts movement and art and is also known as the dish of the dish art university . <end>
<start> a severed wasp , isbn number 0 374 26131 8 , is currently in print . <end>	<start> a severed wasp is available in print and has the isbn number 0 374 26131 8 . <end>
<start> akeem priestley s club is rops which plays in the veikkausliiga . <end>	<start> the acf fiorentina is part of the order of parana . <end>
<start> american buzz aldrin was a fighter pilot who later joined the apollo 11 program where he spent 52 minutes in space . aldrin was born january 20th , 1930 in glen ridge , new jersey and in 1963 he graduated from mit with a sc . d . <end>	<start> buzz aldrin was born in glen ridge , new jersey on january 20 , 1930 . he graduated from mit in 1963 with a doctorate in science , was a fighter pilot and was selected by nasa in 1963 as a crew member of apollo 11 . he spent a crew member on apollo 11's apollo 11 crew member . <end>
<start> alan shepard died in california , and had a medal and award for distinguished service in the united states navy , and a gold medal for department of commerce . dianne feinstein is the senator of california . <end>	<start> alan shepard was born in new hampshire and died in california . he was awarded the distinguished service medal by the united states navy which ranks higher than the department of commerce gold medal . <end>
<start> the epoch of 19255 1994 vk8 is on 31 december 2006 . it has an orbital period of 8788850000 . 0 , a periapsis of 6155910000000 . 0 and an apoapsis of 6603633000 . 0 km . <end>	<start> the inauguration date of the dish acm transactions on information systems is 8 . the airport is 8 33 and has a total area of 8 . 8 square metres and a total area of 8 . 8 square kilometres . <end>
<start> abdulsalami abubakar's birthplace was niger state . <end>	<start> born in buxton . <end>
<start> al asad airbase is in iraq and is operated by the united states air force . the icao location identifier is oraa and the runway , which is called 08 26 has a length of 3990 . <end>	<start> the united states air force is the operating organisation for al asad airbase which is located in al anbar province , iraq . the runway name is 08 26 and the runway length is 3992 . 88 . <end>
<start> alfred n . phillips was part of the u . s . house of representatives and he was born in connecticut . <end>	<start> the birth place of alan shepard born in new hampshire is the united states born in america and was the us national service ribbon . <end>
<start> as gubbio 1910 is located in italy where the italian language is spoken and pietro grasso is the leader . the country is inhabited by italians who have rome as their capital city . <end>	<start> pietro grasso and sergio mattarella are leaders in italy , where the capital is rome and italian people are called italians . the italian people are known as pietro grasso and pietro grasso . <end>
<start> the leader of france is manuel valls where the euro is the currency and the dish baked alaska is from . <end>	<start> baked alaska is from france where the currency is the euro and the leaders are gerard larcher . <end>
<start> bionico is found in the region of jalisco . <end>	<start> bionico is a food found in jalisco . <end>
<start> baked alaska is a dish found in the usa which contains christmas pudding and comes from new york . <end>	<start> baked alaska is from the region of new york and is an ingredient in baked alaska , an dish from the united states . <end>
<start> beef kway teow is a popular food of indonesia that comes from the singapore region . its ingredients include kway teow , beef tender loin , gula melaka , dried black beans , garlic , dark soy sauce , lengkuas , oyster sauce , chilli and sesame oil . <end>	<start> beef kway teow is a dish commonly found in singapore and indonesia . its main ingredients include kway teow , beef tenderloin , gula melaka , sliced , dried black beans , garlic , dark soy sauce , lengkuas , oyster sauce , soya sauce , chilli and sesame oil . <end>
<start> anandiben patel was the leader of gujarat , india , where amdavad ni gufa is located . the leader of india's name is sumitra mahajan . <end>	<start> anandiben patel is the leader of india where amdavad ni gufa is located in ahmedabad . the leader of gujarat is sumitra mahajan . <end>
<start> angola , indiana is in the united states where african americans are an ethnic group . <end>	<start> the ethnic group of the united states are the ethnic group of the country where the dish batchoy is found . <end>
<start> aleksandr prudnikov plays for fc tom tomsk and his club is fc spartak moscow , whose grounds are the otkrytiye arena . <end>	<start> the manager of az alkmaar , which has been previously been previously previously been previously previously been previously the manager of az alkmaar . <end>
<start> bionico is from the guadalajara region of mexico . it is a dessert that includes granola . <end>	<start> bionico is a dessert from the guadalajara region of mexico . it contains granola , condensed milk . <end>
<start> attica , part of logan township , indiana , united states , lies 166 above sea level and has a population density of 783 . 1 people for each of its 4 . 14 square kilometres . <end>	<start> attica , indiana is part of the united states . it is part of the state of texas in the u . s . a . and has a runway length of 1 , 982 . the runway name of attica is 4 , noodle , indiana and the total location of attica indiana . <end>
<start> aaron turner performs electroacoustic music and played with the band twilight . <end>	<start> the acharya institute of technology is a character , the library of technology . <end>
<start> german walter baade discovered 1036 ganymed . baade died in gottingen , was a graduate of the university of gottingen and allan sandage was among his doctoral students . <end>	<start> born in dallas and john van den born in new hampshire went to school at the university of technology and was a fighter pilot and was selected by nasa . he was born in dallas and died in california . <end>
<start> the united states has an ethnic group called asian americans . <end>	<start> asian americans are an ethnic group in the united states . <end>
<start> aaron turner , whose origin is the united states , started performing in 1995 . aaron turner performs black metal music , played for old man gloom and is a musician in the lotus eaters band . <end>	<start> the main ingredients of alan shepard are robert a m stern and mary stevens . the institute was created in the state of texas and is affiliated with the united states navy and have the architectural style of william beach and the architectural style of merit ribbon . <end>
<start> adam holloway's residence is gravesend . <end>	<start> the residence of 108 o . <end>
<start> aidaluna , owned by aida cruises , is powered by caterpillar inc . , where douglas r . oberhelman is a key person . caterpillar inc . was founded in the united states and is in peoria , illinois . <end>	<start> the owner of the bbc , founded by john reith , founded by robert a heinlein , is the bbc . the show person r . key person for the bbc is charles richard hall , and the founder of the series is charles reith , and the current tenant of the ac hotel bella reith . <end>
<start> 1974 is one of the model years of the amc matador which was assembled in kenosha , wisconsin . <end>	<start> the 1st runway at appleton international airport is made from greenville , california . <end>
<start> alison o'donnell is a singer and also plays the bodhran , percussion and autoharp . <end>	<start> the main ingredients for albuquerque california are gram flour and raisins . <end>
<start> the alfa romeo 164 was assembled in arese . <end>	<start> the inauguration date for alan shepard comics college is lambien . <end>
<start> the hal light combat helicopter is a helicopter used by the indian air force which operates agra airport . this airport is located in uttar pradesh part of bundelkhand , where ram naik is the leader . <end>	<start> the hal light combat helicopter is the operating organisation of agra airport which is located in uttar pradesh part of awadh , bundelkhand . the airport is operated by the indian air force helicopter known as the hal light combat helicopter and uses the hal light combat helicopter known as the hal light combat helicopter . <end>
<start> asser levy public baths are in new york , usa . gale brewer is the leader of manhattan , which is a part of new york . <end>	<start> the asser levy public baths are located in new york city , manhattan , united states . manhattan is the leader of manhattan , where the asser levy public baths is located . <end>
<start> adare manor's architect was george richard pain and it was completed in 1862 . <end>	<start> adare manor , designed by george richard pain , was completed in 1862 . <end>
<start> ab klink was born in stellendam in the netherlands , where the national currency is the euro . <end>	<start> the currency of the currency of the currency of the currency of the currency of the currency of the currency of the currency of the currency of the currency is the euro . <end>
<start> yuzhnoye design office created the antares rocket whose initial flight took place july 13 , 2014 at the mid atlantic regional spaceport launch pad 0 . the rocket is 3 . 9 m in diameter and took its last trip on oct . 28 , 2014 . <end>	<start> the inauguration date of the bbc are edwin e . october 1983 and was on the 3rd october 1983 and was founded by huseyin butuner and hilmi guner . he is now retired . <end>
<start> alfredo zitarrosa died in montevideo , uruguay where the natives are known as uruguayans . the city's leader is daniel martinez . <end>	<start> the demonym for natives of the republic of ireland is the indian people . the people of the country are called spaniards , who live in the country where the people who live is greeks . <end>
<start> abradab who was born on november 12th 1978 is an artist for the band kaliber 44 and he is with rapper associated with magri . <end>	<start> alan shepard was born on march 15 , 1932 in wheeler , texas . he was a test pilot and was selected by nasa in 1963 . <end>
<start> buzz aldrin graduated from massachusetts institute of technology with a sc . d in 1963 . <end>	<start> buzz aldrin , who graduated from massachusetts institute of technology in 1963 with a sc . d in 1963 . <end>
<start> the mid size acura tlx car was assembled in marysville ohio with a front wheel all wheel drive and a honda k engine . <end>	<start> the main ingredients of the acharya institute of technology are red granite and white rice , cuttlefish or squid , cephalopod ink , and it is part of the main ingredients of the dish of the dish known as the dish of the dish of the dish of the dish of the dish of the dish of the dish of the dish of the dish of the architecture style of the dish of the dish of the dish of the dish of the dish of the architecture style of the dish of the dish of the dish of the dish of the dish of the dish of the dish of the dish of the dish of the architecture style of the dish of the dish of the dish of the dish of the dish of the dish of the dish of the dish of the dish of the dish of the dish of the dish of the dish of the dish of the dish of the dish of the dish of the dish of the dish of the dish of the dish of the dish of the dish of the dish of the dish of the architecture style of the dish of the dish of the dish of the dish of the dish of the dish of the dish of the dish of the dish of the dish of the dish of the dish of the dish of the dish of the dish of the dish of 
<start> awh engineering college is located in kerala whose leader is kochi . <end>	<start> the awh engineering college is located in kerala , kerala . <end>
<start> arlington , texas , has a population density , of 1472 . 0 inhabitants per square kilometre . <end>	<start> the population density of arlington texas is 429 . 9 inhabitants per square kilometre . <end>
<start> standard chinese is a language spoken in singapore where the leaders are tony tan and halimah yacob . beef kway teow is popular in singapore and indonesia . <end>	<start> beef kway teow is a dish from singapore and indonesia . the country's leaders include tony tan and halimah yacob . the dish is popular in singapore and singapore . <end>
<start> the stylistic origin of indie rock is new wave music . <end>	<start> the land date of ardmore airport is 140 . <end>
<start> the american locomotive co . was founded in schenectady , new york and is located in the us . it built the alco rs 3 which is 17068 . 8 mms in length . <end>	<start> the owner of the ac york college in the united states and the current tenants are robert a m international airport . the institute is located at egg harbor township , new york , and they have a total area of 30843 . 8 square metres . <end>
<start> part of colombian cuisine , bandeja paisa is a traditional dish from the paisa region . one of the main ingredients in this dish is avocado . <end>	<start> avocado is one of the ingredients in bandeja paisa which is a dish from the paisa region , in the paisa region . <end>
<start> atlantic city is part of new jersey . <end>	<start> atlantic city , new jersey is part of new jersey . <end>
<start> arlington is part of texas , in the u . s . <end>	<start> arlington is part of the united states . <end>
<start> akron is located in summit county , ohio . <end>	<start> akron is located in summit county , ohio . <end>
<start> bhajji comes from the country india , where indians live . <end>	<start> bhajji is from india , where the people are known as indian . <end>
<start> ace wilder , a solo singer and songwriter , was born on july 23 , 1982 in stockholm . <end>	<start> william anders was born on october 17th 1933 in british hong kong on october 17th , 1933 . he was a fighter pilot and joined nasa in 1963 . <end>
<start> the capital of romania is bucharest . <end>	<start> the capital of romania is bucharest . <end>
<start> airey neave was awarded the military cross . <end>	<start> roy thomas won the black pirate . <end>
<start> akeem adams plays for w connection fc , having previously played for united petrotrin f . c . , whose ground is palo seco . <end>	<start> the manager of a . c . chievo verona is rolando maran who plays for the club f . c . and has been manager of fc kolin . <end>
<start> buzz aldrin was born in glen ridge , new jersey . he joined nasa in 1963 where he became a crew member of apollo 11 as a fighter pilot . <end>	<start> buzz aldrin was born in glen ridge , new jersey and joined nasa in 1963 as a fighter pilot and became a member of apollo 11 crew . <end>
<start> available in print form , '1634 the bavarian crisis' by virginia demarce and eric flint has 448 pages . <end>	<start> the printed book 1634 the bavarian crisis was written by virginia demarce and eric flint . it has 448 pages and was put in print . <end>
<start> the adare manor is in the republic of ireland , which leader is enda kenny . the architect is augustus pugin , who was born in bloomsbury . one of the significant buildings designed by augustus pugin is the palace of westminster . <end>	<start> the architect of adare manor is augustus pugin , who was born in bloomsbury . the architect of the palace of westminster , the palace of westminster , and the currency is the palace of westminster . <end>
<start> 1101 clematis has a mass of 5 . 7 kilograms , an orbital period of 183309000 . 0 and its epoch date was on 31st july 2016 . it has an escape velocity of 0 . 02 km sec and its apoapsis is 520906000 . 0 kilometres . <end>	<start> the architectural style of the dish acm transactions on information systems is 7 31 . the airport is 4 . 0 long and has a total area of 30843 . 8 square kilometres . the coden code of william anders is 4 . 0 and the club has a total area of 30843 . 8 square kilometres . <end>
<start> akita museum of art is located in japan . <end>	<start> akita museum of art is located in japan . <end>
<start> the epoch of 1097 vicia is on 13 january 2016 . <end>	<start> the inauguration date of the national date of the national football date is 18 . <end>
<start> buzz aldrin was born in glen ridge , located in the essex county in new jersey . <end>	<start> buzz aldrin was born in glen ridge , essex county , new jersey . <end>
<start> aaron turner plays progressive metal music . <end>	<start> the genre of alexandria , is 1 . <end>
<start> chicharron is one of the ingredients in bandeja paisa . <end>	<start> bandeja paisa , is a dish from the antioquia department region . <end>
<start> awh engineering college kuttikkattoor , india was established in 2001 . one of the rivers in india is the ganges . <end>	<start> the awh engineering college in kuttikkattoor , india was established in 2001 and is the river ganges river . <end>
<start> aleksandr prudnikov , who plays for fc kuban krasnodar , played for fc terek grozny . rashid rakhimov is the manager of fc terek grozny , the ground of which , is based at grozny . <end>	<start> the manager of afc ajax is john van den brom who plays for the netherlands national football team and the netherlands national football team and the austria wien club . <end>
<start> atlantic city is located in atlantic county , new jersey , united states . <end>	<start> atlantic city international airport is located in egg harbor township , n . j . in the u . s . <end>
<start> the academic discipline of aids journal is hiv issn number 1473 5571 . studies hiv aids . <end>	<start> the aids journal is published in hiv aids and belongs to the academic discipline hiv aids and has the issn number 1473 5571 . <end>
<start> alvah sabin , who was from vermont , represented the state's 3rd congressional district and he worked as the secretary of state of vermont . sabin ended his career on march 3rd , 1857 and as a point of interest , the largest city in the state is burlington . <end>	<start> the 14th new jersey volunteer infantry monument is located on the 15th of october 3rd , san sebastian de los reyes and has been given as its motto and was created on the 15th of october 3rd , 1932 . the 1st of the 1st of bananaman has been awarded the distinguished service medal by the us region and the us of the us of the us of the us of the cornwall region has the cornwall 15 of the cornwall 15 of the cornwall 15 of the cornwall 15 of the cornwall 15 of the cornwall 15 of the cornwall and has also has been founded by the 1st of the 1st of the 1st of the 1st of the 1st of the 1st of the 1st runway name . <end>
<start> atlantic city is part of new jersey in the united states , whose capital is washington d . c . <end>	<start> the capital of the united states is washington d . c . and the capital city is washington d . c . the language of atlantic city is don guardian . <end>
<start> stephen yong kuet tze is abdul rahman ya'kub's deputy . abdul taib mahmud was abdul rahman ya'kub's successor . <end>	<start> the founder of the bbc is john cowper powys . <end>
<start> 1097 vicia has an average speed of 17 . 92 kilometres per second . <end>	<start> the inauguration date for the inauguration date for the inauguration date for william anders is january 121 . <end>
<start> abdul taib mahmud was born in the kingdom of sarawak and he succeeded abdul rahman ya'kub . stephen yong kuet tze is the deputy to abdul rahman ya'kub . <end>	<start> the founder of the comics series is robert a m stern and the founder of the comics series was john geering . <end>
<start> curitiba is part of the south region , brazil . <end>	<start> curitiba is part of the south region of brazil . <end>
<start> montreal locomotive works built the alco rs 3 between may 1950 and aug . 1956 . it has a v12 engine and diesel electric transmission . <end>	<start> the architect of the port authority of new york and new jersey was robert a m stern and the 1st superhero was designed by john cowper powys . the founder of the comics company is 1st baron m . a . and the first aired on the 1st of merit 1st of 1976 . <end>
<start> the usaf was involved in the 1986 bombing of libya . <end>	<start> the usaf , the usaf bombed libya in 1986 was involved in the united states . <end>
<start> walt disney studio motion picture distributed the film big hero 6 , in which ryan potter starred and baymax is a character . <end>	<start> the distributor of big hero 6 , starring ryan potter potter potter potter potter potter potter potter potter potter potter is walt disney studios motion pictures . <end>
<start> ac hotel bella sky copenhagen has 23 floors and is located in denmark . the tenant is marriott international . <end>	<start> ac hotel bella sky copenhagen is located in copenhagen and has 23 floors . <end>
<start> alderney airport's first runway is made from poaceae which is from the monocotyledon class . <end>	<start> the 1st runway at alderney airport is made from poaceae which is in the class monocotyledon . <end>
<start> agustin barboza was born in asuncion , paraguay which is led by juan afara . <end>	<start> born in buxton , the leader of the country is the labour party and the birthplace of the born in addis ababa city hall is the birthplace of the mayor of bananaman . <end>
<start> the musician andrew white's genre is alternative rock , the genre which has the sub genre christian alternative rock . <end>	<start> the comic character , blockbuster , was created by gardner fox and tom lyle . <end>
<start> prime minister of azerbaijan is the official title of the leader of azerbaijan . <end>	<start> the leader of azerbaijan is the prime minister of azerbaijan . <end>
<start> the alfa romeo 164 , fiat croma and opel vectra are related forms of transportation . the body style of the alfa romeo 164 is sedan and it's assembly line is in milan . <end>	<start> the founder of the film india is robert a m international . the institute is also known as the following red granite and white marble and the abbreviation of the acharya institute of technology is peter university . <end>
<start> aleksandr prudnikov has played for the clubs fc terek grozny based in grozny , where the manager was rashid rakhimov and fc spartak moscow , whose chairman is sergey rodionov . <end>	<start> the manager of afc ajax and the grounds of afc ajax amateurs , are the chairman of the grounds for the black pirate . the chairman of the grounds for the grounds for the grounds for the university of the grounds for the grounds for the grounds for the grounds for the institute is john van den university . <end>
<start> the aston martin v8 , assembled in the united kingdom leader elizabeth ii , was succeeded by the aston martin virage which was manufactured by aston martin . the v8 and the virage are relative means of transport with the aston martin dbs . <end>	<start> the leader of the country is elizabeth ii and the currency is the indian rupee and the city is the location of the administrative science quarterly . the journal is also known as the journal of the country and the publisher of the journal of the journal of which is wolters kluwer . <end>
<start> francisco franco was the predecessor of juan carlos i of spain . <end>	<start> the founder of the comics series is john geering . <end>
<start> the awh engineering college is located in kuttikkattoor , kerala and it has 250 academic staff . the leader of kerala is kochi . <end>	<start> the awh engineering college is located in kuttikkattoor , kerala , india . kerala has 250 academic staff . <end>
<start> the antares rocket is a medium expendable launch system built at the yuzhnoye design office . <end>	<start> the founder of the comics character is robert a m international airport which was designed by robert a m international airport . <end>
<start> the building at 300 north lasalle , illinois , completed in 2009 , has 60 floors covering an area of 120770 . 0 square metres . <end>	<start> 300 north lasalle , illinois , with 60 floors and a floor area of 120770 . 0 square metres , is located in chicago . <end>
<start> a dish popular in indonesia is asam pedas which is made from fish cooked in hot and sour sauce . <end>	<start> asam pedas is a dish found in indonesia and indonesia . the main ingredients are fish cooked in sour and hot sauce . <end>
<start> adare manor was designed by architect philip charles hardwick and construction finished in 1862 . the manor is owned by j p mcmanus . <end>	<start> adare manor , designed by philip charles hardwick , was completed in 1862 , and is owned by philip charles hardwick . <end>
<start> the american locomotive company was founded in schenectady , new york and built the alco rs 3 which is 17068 . 8 mms in length . <end>	<start> the founder of the comics character is john cowper powys , who publish the bodley series and the location of the ac hotel bella sky in new york . <end>
<start> operated by the united states air force , al asad airbase is in iraq and has a runway length of 3992 . 88 metres . <end>	<start> al asad airbase is operated by the united states air force which has a runway length of 3992 . 88 . <end>
<start> katowice born abradab has been with the band kaliber 44 and associated with rapper , magik . <end>	<start> the alan shepard was awarded the dark 15 and is a main organisation of the alan shepard and the black journal . <end>
<start> the ring of fire ii is written in english and preceded by grantville gazette , grantville gazette ii and 1634 the bavarian crisis . the latter book is written by virginia demarce and eric flint . <end>	<start> the novel 1634 the bavarian crisis was written in english and was preceded by 1634 the ram rebellion . the book was followed by grantville gazette ii and was written by virginia demarce and eric flint . <end>
<start> the germans of romania are one of the ethnic groups in romania which is led by prime minister klaus iohannis and has the anthem desteapta te , romane ! . the capital city of romania is bucharest but the 1 decembrie 1918 university is located in the city of alba iulia . <end>	<start> the germans of romania are an ethnic group in romania which is lead by prime minister klaus iohannis . the capital city is bucharest and the national anthem is desteapta te , romane ! . the country is the location of the 1 decembrie 1918 university which is located in the city of alba iulia , romania . <end>
<start> nikos voutsis and alexis tsipras are leaders in greece where the greek language is spoken . the city of athens , located in the country , is served by athens international airport . <end>	<start> athens international airport serves the city of athens , greece . two of the leaders of greece are alexis tsipras and nikos voutsis . greek is spoken in greece where greek is spoken . <end>
<start> frank de boer once played football for fc barcelona . <end>	<start> frank de boer played for fc barcelona . <end>
<start> rome , italy is where the sauce called arrabbiata is from , it includes olive oil as an ingredient used in it's preparation . <end>	<start> arrabbiata sauce is from the region of rome and contains tomatoes , red chili , garlic and olive oil . <end>
<start> walt disney studios motion pictures distributed big hero 6 , a film starring scott adsit in which baymax first appeared . <end>	<start> the distributor of the film big hero 6 , stars walt disney studios motion pictures . baymax was first film distributed by walt disney studios motion pictures . <end>
<start> the ariane 5 was launched at the ela 3 at the guiana space centre . arianespace made the ariane 5 . <end>	<start> the author of the comic book character blockbuster is john cowper powys , who was published by the bodley head . <end>
<start> the temperature of 10 hygiea is 164 . 0 kelvins and it has an apoapsis of 523951582 . 33968 kilometres . <end>	<start> the total area of aip advances is 1 . 8 square kilometres . <end>
<start> the abarth 1000 gt coupe is a two door coupe with a wheelbase of 2160 millimetres and a with of 1 . 55 metres . <end>	<start> the 1st journal of mathematics has a floor area of 1 . 66 square metres and the abbreviation of the 1st journal is peter stoger . <end>
<start> bacon sandwiches are popular in the uk . ketchup can be added to them and a variation is the blt which is similar to a club sandwich . <end>	<start> the blt is a variation of the club sandwich and bacon sandwich . ketchup can also be one of the ingredients of a bacon sandwich which is a blt which is a variation of a club sandwich . <end>
<start> audi e tron is a division of audi , who make the audi a1 . <end>	<start> the 3rd runway at ardmore airport new zealand is made of macmillan publishers . <end>
<start> matteo renzi and pietro grasso are leaders of italy , the country where rome is the capital and amatriciana sauce is a traditional dish . <end>	<start> pietro grasso and pietro grasso are leaders of italy , where the capital is rome and amatriciana sauce is a traditional italian sauce . <end>
<start> alison o'donnell plays folk music and has played with the mellow candle and flibbertigibbet bands . <end>	<start> the acharya institute of technology is located in the state of karnataka , which has the alternative name of the school of merit and the institute of technology and is affiliated with the visvesvaraya technological university . <end>
<start> akeem ayers was born july 10 , 1989 and debuted with the tennessee titans . he has played for the st . louis rams . <end>	<start> the manager of buzz aldrin was born on the bbc and was born on october 23 october 1983 and was previously a former manager of the bbc which is now now now now now now now peter garden . <end>
<start> the main ingredients of binignit are sweet potatoes and banana . <end>	<start> the main ingredients of binignit are sweet potato and banana . <end>
<start> asian americans are one of the ethnic groups in the united states where barack obama is the leader . it is also the country where 'a wizard of mars' originates from . <end>	<start> barack obama is the leader of the united states where asian americans are an ethnic group . <end>
<start> andra sings rhythm and blues , which originated from blues . <end>	<start> the asser levy public baths has the nickname of the bodley style of architecture . <end>
<start> 4 22 is the runway name of atlantic city international airport which is operated by the port authority of new york and new jersey . <end>	<start> the port authority of new york and new jersey is the operating organisation of atlantic city international airport . the runway name is 4 22 and is 3048 . 0 in length . <end>
<start> the american journal of mathematics studies mathematics . <end>	<start> the american journal of mathematics is published bi monthly and is based in mathematics . <end>
<start> the musical genre of alfredo zitarrosa , who started out as a solo singer , is milonga . <end>	<start> the alternative name of the character of asam pedas is for the genre of the comics genre . <end>
<start> beef is an ingredient of bakso which comes from and is found in indonesia . <end>	<start> bakso is a dish from indonesia , it contains noodles , indonesia and is a dish from indonesia . <end>
<start> adolfo suarez madrid barajas airport is located in madrid , paracuellos de jarama , san sebastian de los reyes and alcobendas and has a runway length of 3500 . <end>	<start> adolfo suarez madrid barajas airport is located at paracuellos de jarama , san sebastian de los reyes and alcobendas . the runway name is 14l 32r and it has a length of 3500 . <end>
<start> akeem adams plays for the trinidad and tobago national football team and the t tec sports club . <end>	<start> buzz aldrin , who plays for the netherlands national football team , is the manager of fc chievoverona . <end>
<start> 11 diagonal street is in south africa , the capital of which is cape town . two of the ethnic groups within south africa are coloured people and asian south africans . <end>	<start> 11 diagonal street is located in south africa , cape town and cape town are ethnic groups of south africa . <end>
<start> alan shepard was awarded the distinguished service medal united states navy and the department of commerce gold medal . he was a crew member of the nasa operated apollo 14 mission . <end>	<start> alan shepard was awarded the distinguished service medal from the united states navy which is higher than the department of commerce gold medal . he was awarded the distinguished service medal in the department of commerce gold medal . <end>
<start> the musician andrew white's genre is alternative rock which has origins in new wave music . <end>	<start> the 14th new jersey volunteer infantry monument is located in the city of gettysburg , new york and has a total of 600 . <end>
<start> aleksandra kovac was born in yugoslavia . <end>	<start> born in buxton , born in buxton . <end>
<start> the asser levy public baths was built in 1904 and are in new york city . they were added to the national register of historic places on 1980 04 23 . <end>	<start> asser levy public baths was constructed in 1904 and is located in new york city . the baths were added to the national register of historic places on 1980 04 23 . <end>
<start> california is home to anaheim , which is led by the united states house of representatives . <end>	<start> anaheim , california is part of the united states house of representatives and is led by the united states house of representatives . <end>
<start> james craig watson , who died of peritonitis , was the discoverer of 103 hera . <end>	<start> the founder of the film big hero 6 was john cowper powys . <end>
<start> asser levy public baths are located in new york city , united states . <end>	<start> asser levy public baths are located in new york city , new york , united states . <end>
<start> attica , in indiana is 166 . 0 above sea level . <end>	<start> attica , indiana is part of the state of indiana . <end>
<start> andrew rayel began his musical career in 2009 . <end>	<start> the start date of alan shepard started in 1700 service in california . <end>
<start> atlantic city international airport is in egg harbor township , new jersey , united states . its runway length is 3048 . 0 . <end>	<start> the runway length of atlantic city international airport is 1873 . 0 , which is located at egg harbor township , new jersey , united states . <end>
<start> marv wolfman has won the kirby award . <end>	<start> marv wolfman won the inkpot award . <end>
<start> atlas ii was launched from vandenberg air force base . <end>	<start> the owner of the 1st journal is agr . <end>
<start> alison o'donnell plays jazz music . <end>	<start> the genre of the comics city of amsterdam . <end>
<start> above the veil is available in hardcover , has 248 pages and was written by garth nix . <end>	<start> above the veil is 248 pages long and is available in hardcover . <end>
<start> the abarth 1000 gt coupe , with a straight four engine , had its final production in 1958 . <end>	<start> the architecture style of alan shepard is william anders , who was first designed in new hampshire and was first aired on the 1st october 1983 . <end>
<start> baked alaska is served in the region of hong kong and known to be from the usa . the main ingredients are meringue , ice cream and sponge cake or christmas pudding . <end>	<start> baked alaska is from the region of hong kong and the main ingredients are meringue , ice cream and sponge cake or christmas pudding . the dish comes from the region of the u . s . the main ingredients are meringue , ice cream and sponge cake or christmas pudding . <end>
<start> bill marriott is one of the key people at the marriott international based in bethesda , maryland and which is a tenant of ac hotel bella sky copenhagen . <end>	<start> bill marriott is a key person at marriott international , which is the tenant of ac hotel bella sky in copenhagen , which is a key person at bethesda marriott . <end>
<start> alex tyus plays in the euroleague for the maccabi ashdod bc club whose coach is zvi sherf . <end>	<start> the manager of a . c . chievo verona is gus poyet who played for chelsea f . c . and also plays for chelsea f . c . and the austria national football team for chelsea fc . <end>
<start> the ground of afc fylde can be found in the county of lancashire , it has 3180 members . <end>	<start> a . f . c . fylde has 3180 members and their ground is warton fylde . <end>
<start> baked alaska is served in the region of hong kong . <end>	<start> baked alaska is from hong kong . <end>
<start> adolfo suarez madrid barajas airport can be found in madrid , paracuellos de jarama , san sebastian de los reyes and alcobendas . <end>	<start> adolfo suarez madrid barajas airport is located at madrid , paracuellos de jarama , san sebastian de los reyes and alcobendas . <end>
<start> atlanta falcons play in atlanta . <end>	<start> the largest city in benton county is french . <end>
<start> amsterdam airport schiphol is 3 . 3528 metres above sea level and its first runway has a length of 3800 meters . <end>	<start> amsterdam airport schiphol is at an elevation of 3 . 3528 from sea level and the 1st runway is 3800 feet long . <end>
<start> a severed wasp is in the english language which is the language spoken in great britain . <end>	<start> a severed wasp was written in english which is spoken in great britain . <end>
<start> stuart parker who plays for stockport county f . c . was a manager at afc blackpool . the club is also located in blackpool . the conservative party uk is the leader of blackpool . <end>	<start> afc blackpool have had stuart parker as their manager . the club is the manager who once their manager is stuart parker who plays for kv mechelen . <end>
<start> jens hartel currently plays for sv germania schoneiche , his first club was fc lokomotive leipzig and he has managed 1 fc magdeburg . <end>	<start> jens hartel has been the manager of 1 fc magdeburg and plays for sv germania schoneiche , and sv germania schoneiche . <end>
<start> the runway length of al taqaddum air base is 3684 . 0 . <end>	<start> the runway length at al taqaddum air base is 3684 . <end>
<start> native americans are on of the ethnic groups in the united states . <end>	<start> native americans are an ethnic group in the united states . <end>
<start> peanut sauce is an ingredient in siomay . <end>	<start> peanut sauce is an ingredient of batagor which is a variation of siomay . <end>
<start> the manufacturer of the aston martin v8 is the aston martin . <end>	<start> the founder of the comics character . <end>
<start> a severed wasp is from the united states where the native americans are an ethnic group . the capital city is washington dc and uses the english language which is also spoken in great britain . <end>	<start> the english language is spoken in great britain and the united states . the capital city is washington d . c . and the original wizard of mars was published . the book originates from the united states where one of the ethnic groups are the native americans . <end>
<start> john madin , the architect who designed 103 colmore row , was born in birmingham . the postal code of that area is b . and the governing body is the birmingham city council . labour politician , john clancy is the leader the area . <end>	<start> 103 colmore row was designed by the architect john madin , who designed 103 colmore row was born in birmingham . the postcode is the postal code of birmingham which is lead by the labour party . <end>
<start> the aston martin v8 is assembled in the united kingdom and has an engine volume of 5 . 3 litres . the aston martin v8 and aston martin dbs are a related means of transport . <end>	<start> the abbreviation of the acharya institute of technology is peter stoger and it is affiliated with the sc wiener neustadt and has the abbreviation of peter miller hospital . <end>
<start> aleksandr prudnikov's club is fc anzhi makhachkala and he played youth football for fc spartak moscow whose grounds are the otkrytiye arena . <end>	<start> the manager of az alkmaar , which is affiliated with the association of ajax and plays for the austria national football team and the austria office service season . <end>
<start> johns hopkins university press u . s . , subsidary of johns hopkins university , publishes the american journal of mathematics first printed in 1878 . <end>	<start> the american journal of mathematics was published by johns hopkins university press in the united states . the journal is published by the american journal of mathematics , parent company based in the united states . <end>
<start> the united states , where the capital is washington dc , includes the ethnic group of african americans . auburn is located in the country and is part of lee county in alabama . <end>	<start> the capital of the united states is washington vi . the country is the location of the state of the state of the state of the state of the state of the state of which is part of the state of the state of the state of the state of the united states and the capital city is washington dc . the country is washington vi . <end>
<start> allen forrest performs hip hop music which comes from disco and funk . drums and bass get their sounds from hip hop music . <end>	<start> the school of business and social sciences at the aarhus university in the city of aarhus is located in the city of aarhus and has a total of 3746 . j . math . the journal has a lccn number of 93645978 . <end>
<start> afonso pena international airport icao location idenitifier is sbct . <end>	<start> the icao location identifier of afonso pena international airport is sao jose dos pinhais . <end>
<start> silvano aureoles conejo is the leader in mexico . the country where the currency is the peso and where the food bionico is found . <end>	<start> bionico is a food found in mexico where the currency is the mexican peso . the leader of mexico is silvano aureoles conejo . <end>
<start> bakewell pudding's main ingredients are almond , jam , butter and eggs . it is a dessert from the derbyshire dales region . <end>	<start> bakewell pudding is a dessert from the derbyshire dales region and contains ground almonds , jam , butter and eggs and can be served warm freshly baked or cold . <end>
<start> the ship alhambra , launched on the 31st may 1855 , has a ship beam of 8 . 3m and is 63800 . 0 millimetres long . <end>	<start> the inauguration date of the acharya institute of technology is 7 aud , and it has a total of 30843 . 8 square metres and a total count of 8 . <end>
<start> artur rasizade was an azerbaijan leader . <end>	<start> the leader of azerbaijan is artur rasizade . <end>
<start> buzz aldrin was born on january 20th , 1930 . he was a crew member on nasa's apollo 11 . the backup pilot for apollo 11 was william anders . aldrin has now retired . <end>	<start> buzz aldrin was born on january 20th , 1930 in glen ridge , new jersey . he was a crew member on apollo 11 operated by nasa . he retired on apollo 11 and retired on january 1st , 1969 . <end>
<start> david cameron is the leader of the united kingdom . <end>	<start> david cameron is a leader in the uk . <end>
<start> a long long way was published in print paperback and has the oclc number 57392246 . <end>	<start> a long long way was published in print paperback . it has 292 pages and the oclc number 57392246 . <end>
<start> the epoch date of 1097 vicia is 2006 . 12 . 31 and has a periapsis measurement of 279142000000 . 0 . <end>	<start> the inauguration date of the ataturk monument in california is 3 october 4 , 019 . <end>
<start> electric guitarist aaron turner was a member of black metal band twilight . death metal is a black metal fusion . <end>	<start> the american journal of technology is also known as the following significant character , including the following and the following big hero 6 . its alternative genre is peter stoger and its rector is peter romance . <end>
<start> general dynamics is the parent company of , the general dynamics electric boat co . which is the builder of the american submarine nr 1 . <end>	<start> the founder of the new york and the publisher of the bodley university , john wiley sons is the publisher of the journal addiction and the publisher of the journal is john wiley sons . <end>
<start> new york city staten island was the birthplace of albert jennnings , who died in dona ana county , new mexico territory , on 1896 02 01 . <end>	<start> alan shepard born in new hampshire and died in california . he was awarded the distinguished service medal by the us navy , which is higher than the department of commerce gold medal . he was born in new hampshire and died in california . <end>
<start> alex plante was born in brandon , manitoba and is 1 . 9304 m high . he is in the anyang halla club . <end>	<start> born in burbank california , the tv location of agremiacao sportiva arapiraquense is the olympic stadium and has been managed by robert a heinlein . <end>
<start> the baku turkish martyrs' memorial designed by huseyin butuner and hilmi guner is located in baku , azerbaijan . it is made from red granite and white marble . it is dedicated to the ottoman army soldiers killed in the battle of baku . the native name for the memorial is turk sehitleri an t . the leader of azerbaijan is artur rasizade . <end>	<start> the baku turkish martyrs' memorial is located in azerbaijan and dedicated to the ottoman army soldiers killed in the battle of baku . the memorial is made of red granite and white marble and is dedicated to the ottoman army soldiers killed in the battle of baku . the memorial is located in azerbaijan where the capital city is baku and the national assembly and the leader is artur rasizade . <end>
<start> attica , indiana is elevated 166 m above sea level with a 4 . 4 sqkm area and has a 783 . 1 inhabitants per sq km population density . <end>	<start> attica , indiana has a total area of 4 . 0 square metres and is located in attica in the state of indiana . the runway name of attica in indiana is 4 , 4 , 4 , 4 , 4 , 4 , 4 , 4 , 4 , 4 . 0 square kilometres . <end>
<start> 19255 1994 vk8 , with a mass of 5 . 6kg , has an apoapsis of 6603633000 . 0 kilometres and an escape velocity of 0 . 0925 km s . <end>	<start> the inauguration code for the dish acm transactions on information systems is 8 . the airport is 8 . 8 square and has a floor area of 8 square kilometres . <end>
<start> the leader of ethiopia is hailemariam desalegn and addis ababa city hall is located in addis ababa located in ethiopia . <end>	<start> hailemariam desalegn is the leader of ethiopia where addis ababa city hall is located in addis ababa . <end>
<start> alfred n phillips was mayor of stamford , connecticut . <end>	<start> the founder of the comics character is charles elkin mathews . <end>
<start> the american locomotive company built the alco rs 3 which has a 4 stroke engine and is 17068 . 8 millimeters long . <end>	<start> the manager of akron new york is robert a m international , who has a total code of 600 . 0g of technology and was founded by robert a . m . stern . <end>
<start> the acharya institute of technology is affiliated with the visvesvaraya technological university in the city of belgaum . <end>	<start> the acharya institute of technology is affiliated with the visvesvaraya technological university in belgaum . <end>
<start> the school of business and social sciences at the aarhus university in aarhus is affiliated to the european university association headquarters in brussels . aarhus has a magistrate government . aarhus has mols to its northeast . <end>	<start> the school of business and social sciences at the aarhus university is located in aarhus , denmark . the school has its headquarters southwest of mols . the school is affiliated with the european university association which has its headquarters in brussels . <end>
<start> 1634 the ram rebellion comes from the united states where the capital is washington dc . <end>	<start> 1634 the ram rebellion was written in the united states where the capital city is washington dc . <end>
<start> the leader party in madrid spain in which the adolfo suarez madrid barajas airport is located , is called ahora madrid . <end>	<start> the adolfo suarez madrid barajas airport is located in alcobendas which is part of the community of madrid in spain . <end>
<start> 300 north lasalle is located in chicago , illinois , united states . the leader of chicago is rahm emanuel and the capital of the state of illinois is springfield . <end>	<start> 300 north lasalle is located in chicago , illinois , united states . the capital city is springfield and the leader of the state is rahm emanuel . <end>
<start> elliot see , a past graduate of the university of texas , austin , died in st louis where the leader is francis g slay . <end>	<start> elliot see attended the university of texas at austin which is affiliated with the university of texas system and died in st . louis . <end>
<start> alfredo zitarrosa , was born in uruguay and died in montevideo . <end>	<start> born in buxton , alan shepard died in california . <end>
<start> julius springer is the founder of springer science and business media which is the publisher of abhandlungen aus dem mathematischen seminar der universitat hamburg . <end>	<start> the founder of springer science media is julius springer science and the publisher is julius springer science and eric flint . <end>
<start> the abhandlungen aus dem mathematischen seminar der universitat hamburg issn number is 0025 5858 . <end>	<start> the issn number of abhandlungen aus dem mathematischen seminar der universitat hamburg is 1865 8784 . <end>
<start> arlington is part of tarrant county in texas where fort worth is the county seat . spanish is spoken in texas where houston is the largest city . <end>	<start> the largest city in italy is fort a . s . a . and one of the ingredients is noodles , pork organs , vegetables , chicken , shrimp and beef . <end>
<start> albert jennings fountain served in the union army . <end>	<start> the birth date of the bbc comics character is charles elkin mathews . <end>
<start> the epoch date of 1089 tama is 26 november 2005 . it has a periapsis of 288749000000 . 0 and 373513000 . 0 km is the apoapsis . <end>	<start> the runway length of the atlantic city international airport is 1 , 121 . <end>
<start> alessio romagnoli plays in the club a . c . milan whose manager is sinisa mihajlovic . he's alos in the italy national under 16's football team . <end>	<start> the manager of a . c . chievo verona is rolando maran who plays for the vicenza calcio and is attached to the club genoa cfc . <end>
<start> the javanese people are an ethnic group of java , where the dish ayam penyet can be found . the dish is from singapore , where tony tan is the leader and the english language is spoken . <end>	<start> the javenese people are an ethnic group in java , where the dish ayam penyet comes from . the dish is a dish from singapore where the leader is tony tan . <end>
<start> the acharya institute of technology is located in soldevanahalli , acharya dr . sarvapalli on radhakrishnan road , hessarghatta main road , bangalore 560090 , and is affiliated with visvesvaraya technological university . dr . g . p . prabhukumar is the director . there have been 700 post graduate students . <end>	<start> the acharya institute of technology is located in soldevanahalli , acharya dr . sarvapalli radhakrishnan road , hessarghatta main road , bangalore 560090 , india . it has 700 postgraduate students and its director is dr . g . p . prabhukumar and its motto is nurturing excellence . <end>
<start> a glastonbury romance is john cowper powys notable work . <end>	<start> a glastonbury romance was written by john cowper powys who was born in shirley . <end>
<start> the capital of rome is italy whose language is italian . the leader of the country is sergio mattarella and it is occupied by italians . a . s . gubbio 1910 is located there . <end>	<start> italian speaking italy is home to the italian people . the capital city is rome and the italian people who live there are called italians . italian people are the italian people and italian people are also the italian people . <end>
<start> 103 colmore row was designed by john madin who was born in birmingham . <end>	<start> 103 colmore row was designed by john madin born in birmingham and is located in birmingham . <end>
<start> philippines is the home of the soup dish batchoy . the main ingredients are noodles , pork organs , vegetables , chicken , shrimp and beef . <end>	<start> the main ingredients of batchoy are noodles , pork organs , vegetables , chicken , shrimp and beef . it is a dish from the philippines . <end>
<start> stuart parker footballer was at blackburn rovers fc and has also managed afc blackpool . <end>	<start> afc blackpool have had stuart parker as their manager , he is a footballer for chesterfield fc . <end>
<start> massimo drago was at the club asd licita 1931 but currently manages a . c . cesena and plays for s . s . chieti calcio . <end>	<start> massimo drago has been the manager of a c cesena and was previously previously previously previously previously previously previously previously previously a player for s . d . potenza calcio . <end>
<start> aaron bertram , whose musical genre is ska punk , plays for the suburban legends band . ska punk originated from ska music . <end>	<start> the main ingredients of the dish of the dish bhajji are chopped fruits , sour cream , condensed milk , granola , and shredded coconut and raisins . <end>
<start> taro is an ingredient in binignit which is a dessert . similarly , a cookie is a dessert . <end>	<start> binignit contains sweet potato and taro . <end>
<start> the fiat croma is related to the alfa romeo 164 . <end>	<start> the library of business and social sciences at the acharya institute of technology is ascqag . <end>
<start> west germany was the birthplace of agnes kant and she resided in doesburg . her alma mater is radboud university nijmegen and she was a member of the house of representatives . <end>	<start> the architect of the 1st baron , john van den baron van den university , who was born in new york , has been awarded the following july 17th , and is the founder of the state of new york . <end>
<start> akeem ayers' former team was tennessee titans and he was number 39 in the draft pick . <end>	<start> the manager of bananaman is john van den huiberts . <end>
<start> ajoblanco , who is from spain , is from andalusia . susana diaz is the leader of andalusia while the leader of spain is felipe vi of spain . <end>	<start> felipe vi is the leader of spain , where ajoblanco is from . ajoblanco is a food found in andalusia , spain , where susana diaz is the leader . <end>
<start> hip hop music originated from funk music . <end>	<start> the bed count of art is 1080 . <end>
<start> a . s . gubbio 1910 has a ground in gubbio which is a region of umbria . <end>	<start> a . s . gubbio 1910 is located in the salvadoran primera region and also known as the leading party at the u . s . <end>
<start> st louis , part of greater st louis , is led by francis g slay and is the birthplace of alex tyus . <end>	<start> st louis , whose mayor is francis g slay , is affiliated with the university of texas system and is the location of elliot see who died in st . louis . <end>
<start> sara miller mccune is the founder of sage publications which publishes the administrative science quarterly which has the issn number of 0001 8392 . <end>	<start> the administrative science quarterly was published by sage publications for the samuel curtis johnson graduate school of management , cornell university . <end>
<start> antwerp international airport is 12 metres above sea level . <end>	<start> antwerp international airport is located at 12 metres above sea level . <end>
<start> chicken is a type of bird . <end>	<start> the class north west is brazil . <end>
<start> the ara veinticinco de mayo v 2 was sold to the netherlands on the 1st of april 1948 . <end>	<start> the 1st runway at amsterdam airport schipol is 2 2 2 2 and was completed on 1st 1st 1st 1st 1st 1st 1st 1st 1st 1st 1st 1st 1st respectively . <end>
<start> william anders is a us citizen , who was born in british hong kong and graduated from afit , m . s . in 1962 . he is a retired test pilot , retiring on 1 . 09 . 1969 . he was a crew member on apollo 8 . <end>	<start> william anders was born in british hong kong on october 17th 1933 . he graduated from afit in 1962 with an m . s . he retired on september 1st 1969 . <end>
<start> alan shepard was born in new hampshire and died in california . he was a crew member of apollo 14 which is operated by nasa . he was awarded the distinguished service medal in the us navy , which is higher than the dept of commerce gold medal . <end>	<start> alan shepard was born in new hampshire and died in california . he was awarded the distinguished service medal which is higher than the department of commerce gold medal . he was awarded the distinguished service medal which ranks higher than the department of commerce gold medal . alan shepard died in california . <end>
<start> olusegun obasanjo was succeeded by abdulsalami abubakar of the nigerian army and was in office during atiku abubaker's vice presidency . <end>	<start> the bbc broadcast the dark turkish series which was born in new hampshire and served as a fighter pilot and was shown on the bbc which was shown on the 1st october 1983 . <end>
<start> black metal musician aaron turner is a member of sumac and plays electric guitar . death metal is a black metal fusion . <end>	<start> the american journal of technology is also known as the following significant character , john lake and the following big hero 6 . the latter is also known as the black journal , which has the alternative name of the black journal . <end>
<start> auburn is part of lee county in alabama within the united states . native americans are one of the ethnic groups in the united states of america . <end>	<start> the main ingredients of the native state of the united states are the native americans and the native state of the united states and is home to the native state of the native state of the native state of new york state of which is located in the united states . <end>
<start> abraham lincoln was a commander during the american civil war in which staten island born albert jennings fountain fought . <end>	<start> born in burbank california , the founder of the comics sauce was james october patten . <end>
<start> 300 north lasalle is located in chicago , dupage county in illinois , where rahm emanuel is the leader . <end>	<start> 300 north lasalle is located in chicago , dupage county , illinois , united states . <end>
<start> the polish soviet war , which was part of the russian civil war , was where adam koc fought and where leon trotsky was a commander . <end>	<start> the acharya institute of technology which was founded in the following division of flowering plants and is a tenant of the acharya institute of technology which is the operation organisation of the institute of physics . <end>
<start> bionico is served at the dessert course , which variation is a cake . it is a food found in mexico , which leader is silvano aureoles conejo and mexican spanish is the language . <end>	<start> bionico is a food found in mexico where the leader is silvano aureoles conejo and the spoken language is spanish . the dish is served as a variation of dessert and is served as a dessert . <end>
<start> the leader for albuquerque , new mexico in the united states is the united states house of representatives . <end>	<start> the united states house of representatives is the leader of albuquerque , new mexico which is the location of the united states house of representatives . <end>
<start> mulatu teshome is an ethiopian leader . <end>	<start> the leader of ethiopia is malatu teshome . <end>
<start> andrews county airport is 973 metres above sea level . <end>	<start> andrews county airport is 973 metres above sea level . <end>
<start> the epoch date of 110 lydia is 31 december 2006 and it has an orbital period of 142603000 . 0 . <end>	<start> the total date of 3 october 3 3 is 4 , 214 . <end>
<start> fc magedburg has 27250 members and was in regionalliga in 2014 . <end>	<start> 1 fc magdeburg has 27250 members and played in the 2014 15 season in the 2014 season . <end>
<start> antwerp international airport serves the city of antwerp which is in belgium . where the dutch is the language and the is philippe of belgium . <end>	<start> philippe of belgium is a leader of belgium where the dutch language is spoken . antwerp international airport serves the city of antwerp , where antwerp international airport is located . <end>
<start> alan bean , who is now retired , was born on march 15th , 1932 . <end>	<start> alan bean was born on mar 15 , 1932 , and retired . <end>
<start> 19255 1994 vk8 has a mass of 5 . 6kg , an orbital period of 8788850000 . 0 and its epoch date was on 31 december 2006 . it has a periapsis of 6155910000000 . 0 and its apoapsis is 6603633000 . 0 kilometres . <end>	<start> the inauguration date of the dish acm transactions on information systems is 8 . the airport is 8 . 8 square and has a total area of 8 . 8 square metres and a total area of 8 . the coden code of protein , a total of 8 square metres . <end>
<start> buffalo new york is part of erie county new york . <end>	<start> buffalo new york is part of new york . <end>
<start> 101 helena mass 3 . 0kgs has an escape velocity of 0 . 0348 kilometres per second and its apoapsis is 441092000 . 0 kms . <end>	<start> the abbreviation of the atlantic city international airport is 3 math . 0 and has a total area of 3 square metres and a runway length of 1 , 800 . <end>
<start> the addis ababa city hall is located in addis ababa , ethiopia . <end>	<start> addis ababa city hall is located in addis ababa which is in ethiopia . <end>
<start> amsterdam airport schiphol serves the city of amsterdam and has a runway length of 2014 . 0 . <end>	<start> amsterdam airport schipol serves the city of amsterdam and has a runway length of 2014 . 0 . <end>
<start> the epoch date of 1097 vicia , which had 1928 pc as its former date , is 2006 . 12 . 31 . vicia has a periapsis measurement of 279142000000 . <end>	<start> the inauguration date of the bbc is 3 october 1983 and the name of the runway is charles 31 . <end>
<start> the launch site of the ariane was ela 3 launchpad , the site of which , is situated at the guiana space centre . the guiana space centre is located in kourou , french guiana . <end>	<start> the founder of the dark hero 6 is the bodley company and the location of the bodley series is john cowper powys . <end>
<start> the bakewell tart is a variation of bakewell pudding and has fruit preserves as an ingredient . it originates in the county of derbyshire and specifically the derbyshire dales where patrick mcloughlin is a leader . <end>	<start> patrick mcloughlin is the leader of derbyshire dales where bakewell pudding comes from . it is a variation of bakewell pudding and contains fruit preserves . <end>
<start> audi a1 is made by audi , a subsidiary of which , is the quattro gmbh . <end>	<start> the novel into battle is a sequel to the bodley head . <end>
<start> abdulsalami abubakar was born in minna . <end>	<start> born in buxton . <end>
<start> former los angeles rams team member , akeem ayers , was number 39 in the draft pick , in draft round 2 . <end>	<start> the nickname of the bbc is john la see , who was born in la paz , california . <end>
<start> banana is an ingredient in binignit which is a dessert . a cookie is also a dessert . <end>	<start> banana is an ingredient of binignit which is a dish served as a dessert course . <end>
<start> the novel castle is written in english . <end>	<start> the language of the english is english . <end>
<start> the asser levy public baths are in new york city in the u . s . new york city has a leader called cyrus vance jr . and it is part of manhattan and new netherland . <end>	<start> the asser levy public baths are located in new york city , manhattan , united states . manhattan is one of the leaders of new york city , which is lead by gale brewer . <end>
<start> andra was born in campia , turzii in 1986 . she is a dance pop music singer and makes a living as a singer and reality television judge . <end>	<start> born in new hampshire and served as a test pilot , john cowper powys and the founder of the dark ages . the book was born in burbank california , and the founder of the state of the state of which is charles cowper powys . <end>
<start> the book alcatraz versus the evil librarians is written in english . <end>	<start> alcatraz versus the evil librarians is written in english . <end>
<start> aleksander barkov jr's birthdate is 1995 09 02 . <end>	<start> the birth date of william anders was october 17th , 1933 . <end>
<start> guiana space centre was the launch site of the ariane 5 . <end>	<start> the founder of the bodley series is charles elkin mathews . <end>
<start> auburn , king county , washington is located within the united states . the capital of the united states is washington dc . <end>	<start> the capital of the united states is washington dc . the state of washington dc and washington , d . c . is the capital of the united states . <end>
<start> the acta mathematica hungarica , abbreviated to acta math . hungar , discipline is math . the lccn number is 83646315 and the issn number is 0236 5294 . <end>	<start> the abbreviation of acta mathematica hungarica is acta math . hungar . and the lccn number is 83646315 . the lccn number is 83646315 . it is often an lccn number of 83646315 . <end>
<start> t . s . thakur was an indian leader but the current leader of india is narendra modi . amdavad ni gufa is located in gujarat , india . <end>	<start> narendra modi and narendra modi are leaders in india where amdavad ni gufa is located in ahmedabad . <end>
<start> the location of aarhus airport is tirstrup , part of the central denmark region , in denmark . where the leader is margrethe ii of denmark and where the language is faroese . <end>	<start> aarhus airport is located in tirstrup , part of the central denmark region . the leader of denmark is margrethe ii and the language spoken is greenlandic . <end>
<start> al anderson plays with the rock band nrbq . rock has its origiins in the blues and country music , where the banjo is played , and bhangra is a rock fusion . <end>	<start> the dish of the dish of the dish of the dish of the dish of the dish of the dish of the dish of the dish of the dish of the dish of the dish of the dish of the dish of the dish of the dish of the dish of the dish of the arts and new york sauce , the dish of the black pudding has an academic staff of staff , and a variation of the dish of the dish of the black journal , the black journal , the dish of the ingredients of the dish of the dish of the dish of the dish of the dish of the dish of the dish of the dish of the dish of the dish of the dish of the dish of the black square rock , and is a variation of the black square assembly , and has a variation of the dish of the arts and has a variation of the black journal , and has a variation of the black journal , and has a total style of the dish of the dish of the dish of the dish of the dish of the dish of the dish of the arts and a total style of the dish of the dish of the dish of the dish of the dish of the dish of the dish of the dish of the dish of the dish of the dish of the dish of 
<start> 1 decembrie 1918 university is located in romania , which has as its capital , bucharest . the country's national anthem is desteapta te , romane ! and one of the ethnic groups is germans of romania . <end>	<start> the 1 decembrie 1918 university is in romania . the capital of romania is bucharest and the ethnic group is germans of romania . the germans of romania and the country is the capital of romania and the country is desteapta te , romane ! <end>
<start> austin is located in texas . <end>	<start> austin is part of texas . <end>
<start> construction of 250 delaware avenue , buffalo , new york , began in january 2014 in the postmodernist style of architecture . the building has 12 floors with a total area of 30843 . 8 square metres . <end>	<start> 250 delaware avenue in buffalo , new york has a floor area of 30843 . 8 square metres and a floor count of 12 . the building was completed in january 2014 . <end>
<start> austin texas is led by a mayor and is located in the united states where asian americans are one of the ethnic groups . <end>	<start> the leader of the united states is called the european parliament and the asian americans are an ethnic group in the us . <end>
<start> bandeja paisa is part of colombian cuisine that originates from the paisa region . main ingredients are kidney beans , red beans , pork belly , white rice , ground meat , chicharon , fried egg , plantain patacones , chorizo , arepa , hogao sauce , black pudding morcilla , avocado and lemon . <end>	<start> the main ingredients of bandeja paisa are red beans , pork belly , white rice , ground meat , chicharon , fried egg , plantain patacones , chorizo , arepa , hogao sauce , black pudding morcilla , avocado and lemon . the dish comes from the paisa region of colombia . <end>
<start> 1000 piazzia has an escape velocity of 0 . 0252 kilometres per second . <end>	<start> the runway length of acm transactions on information systems is 75 . 0 . <end>
<start> binignit is a type of dessert with the ingredient sago , a cookie is also a dessert . <end>	<start> sago is one of the ingredients of binignit , which is a dish served as a dessert , as is a dish that contains sago . <end>
<start> ahmet davutoglu is the president of turkey the leader . while the capital of turkey is ankara , the largest city is istanbul . turkey is the location of the ataturk monument izmir . <end>	<start> turkey's largest city is istanbul , the capital is ankara . the ataturk monument is located in turkey . turkey's largest city is istanbul and the leader is ahmet davutoglu . <end>
<start> english is the language of the united states . <end>	<start> the english language is spoken in the united states . <end>
<start> albennie jones , performed in the rhythm and blues genre and ended his career in 1950 . rhythm and blues originated from blues music and has disco as a derivative . <end>	<start> the american alan shepard was born in new hampshire and was awarded the architecture style of the 1st journal and first aired on the 1st of august 1st , 1974 . <end>
<start> airey neave was part of the battle of france but started his career on march 4th , 1974 . <end>	<start> the inauguration date of the bbc started on october 17th , 1933 . <end>
<start> the antares rocket was launched at the mid atlantic regional spaceport launch pad 0 . <end>	<start> the founder of the comics assembly is robert a . m . <end>
<start> a glastonbury romance preceded weymouth sands . <end>	<start> a glastonbury romance was preceded by weymouth sands . <end>
<start> austin is in hays county texas , where the state's largest city is houston . san marcos is the county seat of hays county , texas . <end>	<start> austin is the largest city in hays county , texas , which is the location of the largest city in texas . the county is the county state and the largest city is austin . <end>
<start> aleksandr prudnikov's club is fc spartak moscow and he also plays for the fc kuban krasnodar club . <end>	<start> buzz stoger is the manager of the az alkmaar . <end>
<start> the runway name of adolfo suarez madrid barajas airport is 18l 36r . <end>	<start> the runway name of adolfo suarez madrid barajas airport is 18l 36r and the runway name is 18l 36r . <end>
<start> the ground of a . s . gubbio 1910 is located in italy , where there are leaders called pietro grasso and sergio mattarella and the capital is rome . <end>	<start> pietro grasso and sergio mattarella are leaders in italy where the capital city is rome and the capital city is rome . the ground of a . s . gubbio 1910 is located . <end>
<start> the u . s . a . 's 14th new jersey volunteer infantry monument in frederick county , maryland is in the monocacy national battlefield . it's in a historic district and was established om july 11th , 1907 . <end>	<start> the 14th new jersey volunteer infantry monument is located on the monocacy national battlefield in frederick county , maryland , united states . the monument was established on 11 july 1907 and is categorised as a historic district in the united states . <end>
<start> auburn , alabama is part of lee county in the united states . <end>	<start> abilene , alabama is part of the united states . it is part of the state of alabama in the united states . <end>
<start> the brazilians are one of the ethnic groups found in japan which is the location of the akita museum of art , akita , akita prefecture . <end>	<start> the brazilians are an ethnic group in japan where the akita museum of art is located in akita , akita prefecture . <end>
<start> songwriter and solo singer ace wilder was born in stockholm in 1982 . <end>	<start> the birth place of the character baymax is the series of bananaman . he was born in burbank 1933 and served as a fighter pilot . <end>
<start> alfred moore scales started his career on 1875 03 04 . <end>	<start> the start date of alan shepard was started on january 15 october 6 . <end>
<start> trance musician andrew rayel is associated with musical artists jonathan mendelsohn and bobina . <end>	<start> the 14th new hampshire volunteer infantry monument is also known as the following school of science and is located in the state of texas and was preceded by the grantville gazettes and the grantville gazette iii . <end>
<start> amc matador is manufactured by american motors where roy d chapin jr is a key person and was succeeded ny eagle . <end>	<start> the main ingredients of the character baymax are robert a s hall in the following house of birkenhead , and is a main person with the following rooms and is called the library of congress classification of the 1st hall . <end>
<start> the launch site of alv x 1 was mid atlantic regional spaceport . <end>	<start> the 1 decembrie 1918 university is located on the 1 of merit 6 . <end>
<start> hok sve was the architect of the 3arena which was completed in december 2008 and located on north wall quay . <end>	<start> hok sve was the architect of 3arena which was completed in december 2008 . <end>
<start> spanish is spoken in california . <end>	<start> the language spoken in california is spanish . <end>
<start> arlington in the united states is located in the state of texas where the largest city is houston . <end>	<start> the largest city in the state of texas is the united states and the largest city is houston . <end>
<start> the epoch date of 1089 tama , formerly known as a919 ha 1927wb , is 26 november 2005 . <end>	<start> the name of the bbc is john cowper powys . <end>
<start> agustin barboza plays guarania style of music . <end>	<start> the genre of arlington is 1 . <end>
<start> acura tlx is a luxury class of vehicle with a v6 front engine design . it is made at the marysville auto plant . <end>	<start> the owner of the comic character , new zealand is the american institute of mathematics and the coden code for the second runway is lambien . <end>
<start> alfred n . phillips was born in connecticut , and was mayor of stamford , connecticut . alfred n . phillip was a member of the us army , which fought in the whiskey rebellion battle . <end>	<start> the united states national born in burbank new hampshire , the founder of the united states were robert a m . a . in the united states navy awarded the distinguished service medal from the us navy , the us navy , which is higher than the department of commerce gold medal . the us was born in the us and was awarded the us which is the us fighter pilot . <end>
<start> 1634 the bavarian crisis was written by eric flint who was born in burbank , california . it was the sequel to grantville gazette lll which was a demarce short story . <end>	<start> eric flint was born in burbank california and wrote 1634 the bavarian crisis . the book was preceded by grantville gazette iii , and was preceded by grantville gazette iii . <end>
<start> auburn is part of lee county , alabama in the united states . african americans are an ethnic group within the united states . <end>	<start> the state of the united states is the location of the state of illinois in the united states and is part of the state of the state of texas in the united states . one of the ethnic groups in the country are the african american state of the north west of the united states . <end>
<start> the musical genre of abradab is hip hop music . <end>	<start> the genre of alexandria , is 1 . <end>
<start> angola , indiana is in the u . s . where native americans are an ethnic group , and the inhabitants are called americans . <end>	<start> the people of the united states are called americans and the people of the country are called the indian people . the country is the location of the 1 decembrie 1918 university . <end>
<start> amsterdam airport schiphol serves amsterdam and the runway length is 3300 . <end>	<start> the runway length of amsterdam airport schiphol is 3453 . 0 . the airport serves the city of amsterdam and has a length of 3453 . 0 . <end>
<start> bionico can be varied by using cottage cheese . <end>	<start> bionico can be varied using cottage cheese . <end>
<start> the area code for albany , georgia is 229 . <end>	<start> albany , georgia has the area code 541 and 458 . <end>
<start> 109 felicitas , with an escape velocity of 0 . 0473 kmps , has an epoch date of 31 december 2006 , an orbital period of 139705000 . 0 and a periapsis of 283326000000 . 0 . <end>	<start> the inauguration date of the dish acm transactions on information systems is for the indian air force and has a total area of 1 , 992 . 8g of protein , 4 , 17 , 972 , and is 4 . 7  . 7 square kilometres . <end>
<start> the currency of india is the indian rupee . <end>	<start> the currency of india is the indian rupee . <end>
<start> guanciale is an ingredient used in the preparation of amatriciana sauce which is a traditional italian sauce , that comes from the region of lazio . <end>	<start> amatriciana sauce is a traditional italian sauce from the lazio region and one of its ingredients is guanciale . <end>
<start> alan frew's genre is rock music , which originated from country music . the music bhangra is part of the fusion genre , partly coming from rock music . <end>	<start> the american journal of technology is also known as the following and was preceded by the bodley university . <end>
<start> aarhus airport , operated by aarhus lufthavn a s , has a runway length of 2777 . 0 . <end>	<start> aarhus airport has a runway length of 2777 . 0 and is operated by aarhus lufthavn a s . <end>
<start> aleksander barkov jr . was born in tampere , finland and played with the florida panthers . <end>	<start> the manager of asser levy public baths is real levy born in new york jr . and is now attached to the real austria national football team . <end>
<start> the al asad airbase is situated in the al anbar province , iraq and has a runway length of 3090 . 0 . <end>	<start> the al asad airbase is located at al anbar province , iraq , it's runway is called al asad airbase . <end>
<start> the soho press is located in the u . s . <end>	<start> the nationality of ardmore airport is united states . <end>
<start> the alvis speed 25 has a straight six engine and was manufactured by the alvis car and engineering company that was founded in coventry and succeeded by the rover company . <end>	<start> the founder of the comics sauce is charles elkin mathews , and other founder is charles elkin mathews , it is charles elkin mathews . <end>
<start> 250 delaware avenue is located in the united states , where english is spoken and the leader has the title president . joe biden is one of the leaders . <end>	<start> the english language is spoken in the united states where the leader is called the president . the country is the location of 250 delaware avenue . <end>
<start> 103 hera's mass is 7 . 9kg . <end>	<start> the number of acm transactions on information systems is 7 . <end>
<start> sponge cake is one of the ingredients of baked alaska which comes from the region of new york and france . <end>	<start> baked alaska is from the region of france and contains sponge cake and sponge cake or christmas pudding . <end>
<start> aleksander barkov jr , whose draft team was the florida panthers , was born on 2 september 1995 in tampere , finland . <end>	<start> the architect of william anders was born on october 17th , 1933 and is now the location of the asser levy place on east 23rd october 17th , maryland . the institute was born on october 17th , 1933 and in dallas on the us national service jr . <end>
<start> atlantic city international airport owner is south jersey transportation authority . <end>	<start> atlantic city international airport is owned by atlantic city international airport . <end>
<start> the building of 103 colmore row began in 1973 and it was completed in 1976 . it is located at 103 colmore row , birmingham and it has 23 floors . <end>	<start> 103 colmore row in birmingham , england was completed in 1976 and has 23 floors . <end>
<start> the acura tlx has an awd vehicle layout . <end>	<start> the inauguration date for the comics character . <end>
<start> as livorno calcio play in serie b previous champions carpi fc 1909 and are managed by christian panucci . <end>	<start> a . s . livorno calcio are managed by pietro grasso and plays for serie b and the stadio armando picchi . <end>
<start> j . v . jones is the author of a fortress of grey ice oclc 51969173 isbn 0 7653 0633 6 . <end>	<start> a fortress of grey ice has the isbn number 0 7653 0633 6 , which was published in hardcover and has the oclc number 51969173 . <end>
<start> hok sve was the architect of 3arena , located on the east link bridge . <end>	<start> the 3arena is located at east link link and was designed by the architect hok sve . <end>
<start> asilomar conference grounds , located at asilomar blvd . , pacific grove , california , was added to the national register of historis places february 27 , 1987 and has the reference number 87000823 . <end>	<start> asilomar conference grounds , which is located on asilomar blvd , is located on asilomar blvd , pacific grove , california . it was added to the national register of historic places on 27 february the 27nd 1987 . <end>
<start> angola , in indiana , has an elevation of 324 . 0 metres above sea level . <end>	<start> the elevation above the sea level in angola , is 524 . <end>
<start> solo singer andra was born in romania and her genre is dance pop music . <end>	<start> the architect of the institute of technology is charles cowper powys , and he also served as a test pilot , and also is the location of the administrative science quarterly . <end>
<start> coming from the region mindanao , in the philippines , binignit is a dessert . while sweet potato is one of the ingredients in it , the main ingredient is banana . <end>	<start> binignit contains sweet potato and banana . it is a dessert from the visayas region of the philippines . <end>
<start> serving the city of aplena and located in ridge township , alpena county , michigan , is alpena county regional airport . it is 210 metres above sea level , has a runway with the name 7 25 and a runway that is 1533 . 0 long . <end>	<start> alpena county regional airport is located in maple ridge township , alpena county , michigan , united states . the airport has a runway length of 1533 . 0 . the airport is 2744 meters long and has a runway length of 1533 . 0 . <end>
<start> with 1500 members , a . e dimitra efxeinoupolis , were in the 2014 15 a epsth , greece . <end>	<start> a . e dimitra efxeinoupolis has 1500 members and were in the 2014 15 season . <end>
<start> atlantic city international airport is located in egg harbor township , new jersey , united states . it is operated by the port authority of new york and new jersey , which has its headquarters at the four world trade center . <end>	<start> the port authority of new york and new jersey is the operating organisation of atlantic city international airport . the airport is located at egg harbor township , atlantic county , new jersey , united states . <end>
<start> the alhambra was built by the samuda brothers . <end>	<start> john transactions on the bbc . <end>
<start> abel caballero was born in galicia in spain and he was the minister of transport . he is now a member of the spanish socialist workers' party . <end>	<start> the founder of the film big hero 11 is william anders who designed the chair of the black pirate . the memorial was born in san francisco and is the founder of the state of california . <end>
<start> asam pedas is a food found in malaysia , where the malay live , but comes from sumatra where the batak live . <end>	<start> asam pedas is a food found in sumatra , a country where the malaysian chinese are an ethnic group . <end>
<start> alcatraz versus the evil librarians is published in hardcover and has 320 pages . the oclc number is 78771100 . <end>	<start> alcatraz versus the evil librarians is published in hardcover and has the oclc number 78771100 and the isbn number 0 439 92550 9 . <end>
<start> andrew rayel , is associated with musical artist jonathan mendelsohn and christian burns . <end>	<start> the alan shepard has the alternative name of the bbc and was created by john cowper powys . <end>
<start> a long long way has 292 pages and the isbn number is 0 670 03380 4 . <end>	<start> a long long way has 292 pages and the isbn number 0 670 03380 4 . <end>
<start> albennie jones has worked with the musical artist sammy price . <end>	<start> the library of representatives is robert a . s . <end>
<start> april o'neil was created by peter laird , from the us . <end>	<start> the creator of 3arena is peter laird , who was created by peter laird . <end>
<start> atlanta , is a part of the georgia in the u . s . native americans are an ethnic group in the u . s . <end>	<start> the us is home to the ethnic group of the united states and the country is the home to the bacon explosion which is from the united states . <end>
<start> julia morgan , who was born in san francisco , was the architect of asilomar conference grounds , the los angeles herald examiner building a landmark in california , hearst castle and the asilomar state beach . <end>	<start> julia morgan was born in san francisco and designed several significant buildings including the asilomar state beach and the asilomar state beach . the riverside art musuem , and hearst castle . <end>
<start> born in dothan alabama , allen forrest , started out as a solo singer and performs rhythm and blues music . <end>	<start> the character of bananaman was born in the essex county and also known as buzz aldrin . <end>
<start> tarrant county has its largest city as fort worth . arlington , tarrant county , texas , and austin tx capital is part of the united states . <end>	<start> the largest city in the city in the city of tarrant county , texas , is the largest city in the philippines . the country is the location of the school of business and the state of texas in the state of texas in the state of texas in the state of texas . <end>
<start> ariane 5 was launched at ela 3 and manufactured by the airbus defence and space . <end>	<start> the founder of the institute of technology is john cowper powys . <end>
<start> abraham a . ribicoff was born in connecticut , united states , where he became governor . he was a member of the democratic party in the united states . he died in the united states . <end>	<start> the american william anders was born in new jersey on the 17th of october 1933 . he was selected by nasa in 1963 and served as a crew member of the apollo 8 mission and is now retired . <end>
<start> william anders was born on the 17th of october in 1933 in british hong kong . he was a member on apollo 8 as a fighter pilot . he retired on the 1st of september in 1969 . <end>	<start> william anders was born on 17th october 1933 in british hong kong . he retired on september 1st , 1969 . he was a fighter pilot and retired on september 1st , 1969 . <end>
<start> the american journal of mathematics abbreviated to am . j . math . has the academic discipline of mathematics . <end>	<start> the american journal of mathematics is published bi monthly and is abbreviated to am . j . math . <end>
<start> adonis georgiadis was born in athens and has been the deputy parliamentary spokesman of the popular orthodox rally . <end>	<start> the founder of the comics city of bangalore is charles michel , the series of the series of the series of the series of the series of the series of the series of the series of the series of the series of bananaman . <end>
<start> stanislaw tillich is a leader of germany where rostock is located . the city is the location of neptun werft who built the a rosa luna . <end>	<start> the leader of the city of albuquerque in which is the mayor of the city of lahore , where the leader is called the labour party and the city is the location of the allama iqbal international airport . <end>
<start> footballer , abner , played for the brazilian national under 20 football team . he also for the football club real madrid castilla , the manager of which , is luis miguel ramis . <end>	<start> the manager of afc ajax is gus poyet who plays for real zaragoza and now manages the real zaragoza austria arnhem . <end>
<start> aip advances abbreviated to aip adv . had the eissn number 2158 . <end>	<start> the impact factor of aip advances abbreviated to aip adv . <end>
<start> oladipo diya was mike akhigbe's predecessor , abdulsalami abubakar was in office whilst mike akhigbe was vice president . abdulsalami abubakar , was a member of the nigerian air force , and his succcessor was al amin daggash . <end>	<start> the bbc broadcast the bbc and the founder of the dark 16 fighting fox and the dark 6 . the series was shown on the bbc which was previously a project for the bbc which was born in new york . <end>
<start> jerry ordway is the creator of bibbo bibbowski . <end>	<start> bibbo bibbowski was created by jerry ordway . <end>
<start> abilene , texas is served by the abilene regional airport . <end>	<start> abilene regional airport serves the city of abilene in texas . <end>
<start> arem arem is a food found in indonesia where jusuf kalla is the leader . <end>	<start> arem arem is a food found in indonesia , where jusuf kalla is a leader . <end>
<start> the antares rocket is manufactured at the yuzhnoye design office and launched from the mid atlantic regional spaceport launch pad 0 . the maiden flight took place on 21 april 2013 and the final flight on 18 september 2013 . <end>	<start> the bbc , which was created by robert a m international , is located on october 17th , 1983 and was first aired on the 1st october 1983 and was first broadcast by the bbc . <end>
<start> basim qasim is the manager of al zawra'a sc . <end>	<start> the manager of al taqaddum air base is rolando masum . <end>
<start> alan bean is an american born on march 15 , 1932 in wheeler , texas . he was a test pilot and spent a total of 100305 minutes in space . he is now retired . <end>	<start> alan bean is a us national who was born on 15 march 1932 . he was born in wheeler , texas . he spent a test pilot and a total of 100305 minutes in space was part of the space for apollo 12 . <end>
<start> buzz aldrin was an american born in glen ridge new jersey . he was a fighter pilot and a member of the apollo 11 crew . william anders was the backup pilot and the mission was operated by nasa . <end>	<start> buzz aldrin was born in glen ridge , new jersey and was a fighter pilot and was a crew member of apollo 11 operated by nasa . william anders was a crew member of apollo 11 operated by nasa . <end>
